date,Location,retail_and_recreation_percent_change_from_baseline,grocery_and_pharmacy_percent_change_from_baseline,parks_percent_change_from_baseline,transit_stations_percent_change_from_baseline,workplaces_percent_change_from_baseline,residential_percent_change_from_baseline,New Cases,New Deaths,New Recovered,New Active Cases,Total Cases,Total Deaths,Total Recovered,Total Active Cases,Case Fatality Rate,Case Recovered Rate,Growth Factor of New Cases,Growth Factor of New Deaths,pm10,so2,co,o3,no2,categori
1/3/2020,DKI Jakarta,4,10,-11,6,6,0,2,0,0,2,39,20,75,-56,51.28%,192.31%,,,45,5,13,28,8,BAIK
2/3/2020,DKI Jakarta,6,24,5,5,6,-1,2,0,0,2,41,20,75,-54,48.78%,182.93%,1,1,34,5,15,32,10,BAIK
3/3/2020,DKI Jakarta,3,17,-1,3,5,0,2,0,0,2,43,20,75,-52,46.51%,174.42%,1,1,59,5,23,29,14,SEDANG
4/3/2020,DKI Jakarta,-2,4,-8,1,4,1,2,0,0,2,45,20,75,-50,44.44%,166.67%,1,1,56,7,19,55,16,SEDANG
5/3/2020,DKI Jakarta,3,8,1,4,5,0,0,1,0,-1,45,21,75,-51,46.67%,166.67%,0,,35,6,16,30,13,BAIK
6/3/2020,DKI Jakarta,10,11,19,5,8,0,0,0,0,0,45,21,75,-51,46.67%,166.67%,1,0,36,10,19,33,16,BAIK
7/3/2020,DKI Jakarta,4,12,15,6,7,-1,0,2,0,-2,45,23,75,-53,51.11%,166.67%,1,,37,7,17,28,17,BAIK
8/3/2020,DKI Jakarta,0,6,1,3,6,0,0,0,0,0,45,23,75,-53,51.11%,166.67%,1,0,45,7,16,39,11,BAIK
9/3/2020,DKI Jakarta,3,6,7,3,5,1,0,1,0,-1,45,24,75,-54,53.33%,166.67%,1,,39,6,12,19,11,BAIK
10/3/2020,DKI Jakarta,1,6,2,3,4,1,0,0,0,0,45,24,75,-54,53.33%,166.67%,1,0,30,5,12,33,11,BAIK
11/3/2020,DKI Jakarta,1,3,3,2,4,1,0,0,0,0,45,24,75,-54,53.33%,166.67%,1,1,40,5,15,38,13,BAIK
12/3/2020,DKI Jakarta,-3,-2,-7,1,3,2,2,1,4,-3,47,25,79,-57,53.19%,168.09%,,,48,5,19,39,20,BAIK
13/03/2020,DKI Jakarta,8,9,16,2,5,1,4,1,3,0,51,26,82,-57,50.98%,160.78%,2,1,34,4,17,36,12,BAIK
14/03/2020,DKI Jakarta,-12,2,-17,-8,5,2,2,1,1,0,53,27,83,-57,50.94%,156.60%,0.5,1,64,6,19,87,17,SEDANG
15/03/2020,DKI Jakarta,-20,3,-37,-19,5,4,8,3,0,5,61,30,83,-52,49.18%,136.07%,4,3,50,3,17,42,13,BAIK
16/03/2020,DKI Jakarta,-18,-5,-23,-18,-10,7,2,3,0,-1,63,33,83,-53,52.38%,131.75%,0.25,1,50,4,20,36,19,BAIK
17/03/2020,DKI Jakarta,-16,3,-23,-27,-15,8,2,1,0,1,65,34,83,-52,52.31%,127.69%,1,0.33,41,4,21,57,15,SEDANG
18/03/2020,DKI Jakarta,-22,-3,-28,-32,-19,11,1,1,0,0,66,35,83,-52,53.03%,125.76%,0.5,1,44,3,15,54,12,SEDANG
19/03/2020,DKI Jakarta,-28,-12,-33,-38,-21,12,2,0,1,1,68,35,84,-51,51.47%,123.53%,2,0,62,7,26,37,14,SEDANG
20/03/2020,DKI Jakarta,-30,-11,-32,-42,-23,15,5,3,1,1,73,38,85,-50,52.05%,116.44%,2.5,,48,4,12,51,14,SEDANG
21/03/2020,DKI Jakarta,-35,-5,-38,-40,-10,11,8,3,6,-1,81,41,91,-51,50.62%,112.35%,1.6,1,43,6,15,37,17,BAIK
22/03/2020,DKI Jakarta,-49,-22,-59,-49,-12,14,2,0,3,-1,83,41,94,-52,49.40%,113.25%,0.25,0,34,4,7,42,9,BAIK
23/03/2020,DKI Jakarta,-40,-19,-43,-53,-34,18,0,0,0,0,83,41,94,-52,49.40%,113.25%,0,1,40,4,12,66,13,SEDANG
24/03/2020,DKI Jakarta,-43,-18,-46,-56,-40,19,16,19,3,-6,99,60,97,-58,60.61%,97.98%,,,58,4,20,54,17,SEDANG
25/03/2020,DKI Jakarta,-54,-29,-55,-69,-69,28,1,1,0,0,100,61,97,-58,61.00%,97.00%,0.06,0.05,33,3,7,63,8,SEDANG
26/03/2020,DKI Jakarta,-47,-24,-46,-60,-43,20,57,2,0,55,157,63,97,-3,40.13%,61.78%,57,2,49,4,10,42,10,BAIK
27/03/2020,DKI Jakarta,-46,-17,-43,-61,-44,22,74,7,6,61,231,70,103,58,30.30%,44.59%,1.3,3.5,43,4,9,62,10,SEDANG
28/03/2020,DKI Jakarta,-54,-21,-51,-58,-31,17,48,9,9,30,279,79,112,88,28.32%,40.14%,0.65,1.29,58,6,12,67,14,SEDANG
29/03/2020,DKI Jakarta,-59,-28,-63,-60,-26,17,52,10,0,42,331,89,112,130,26.89%,33.84%,1.08,1.11,61,7,7,56,8,SEDANG
30/03/2020,DKI Jakarta,-51,-26,-50,-63,-45,22,33,7,0,26,364,96,112,156,26.37%,30.77%,0.63,0.7,47,6,9,68,12,SEDANG
31/03/2020,DKI Jakarta,-50,-21,-52,-62,-47,22,44,10,0,34,408,106,112,190,25.98%,27.45%,1.33,1.43,51,11,9,84,10,SEDANG
1/4/2020,DKI Jakarta,-47,-16,-49,-62,-47,21,59,1,0,58,467,107,112,248,22.91%,23.98%,1.34,0.1,38,6,12,67,10,SEDANG
2/4/2020,DKI Jakarta,-48,-19,-46,-63,-47,22,70,5,2,63,537,112,114,311,20.86%,21.23%,1.19,5,32,4,6,33,7,BAIK
3/4/2020,DKI Jakarta,-47,-19,-44,-63,-46,23,71,6,2,63,608,118,116,374,19.41%,19.08%,1.01,1.2,30,5,4,33,5,BAIK
4/4/2020,DKI Jakarta,-53,-21,-52,-60,-34,18,57,8,5,44,665,126,121,418,18.95%,18.20%,0.8,1.33,42,6,8,47,7,BAIK
5/4/2020,DKI Jakarta,-57,-27,-64,-62,-28,17,87,11,2,74,752,137,123,492,18.22%,16.36%,1.53,1.38,50,4,6,63,8,SEDANG
6/4/2020,DKI Jakarta,-50,-30,-52,-63,-44,22,103,7,7,89,855,144,130,581,16.84%,15.20%,1.18,0.64,45,4,8,37,9,BAIK
7/4/2020,DKI Jakarta,-47,-18,-48,-62,-46,21,113,14,3,96,968,158,133,677,16.32%,13.74%,1.1,2,26,3,11,35,9,BAIK
8/4/2020,DKI Jakarta,-48,-23,-51,-63,-46,22,90,8,5,77,1058,166,138,754,15.69%,13.04%,0.8,0.57,26,5,5,31,7,BAIK
9/4/2020,DKI Jakarta,-47,-17,-48,-61,-45,20,228,34,5,189,1286,200,143,943,15.55%,11.12%,2.53,4.25,36,3,5,27,10,BAIK
10/4/2020,DKI Jakarta,-68,-46,-61,-79,-73,34,53,11,4,38,1339,211,147,981,15.76%,10.98%,0.23,0.32,50,2,7,71,10,SEDANG
11/4/2020,DKI Jakarta,-63,-34,-61,-69,-43,22,190,10,7,173,1529,221,154,1154,14.45%,10.07%,3.58,0.91,48,2,6,88,6,SEDANG
12/4/2020,DKI Jakarta,-67,-39,-71,-70,-33,20,156,33,37,86,1685,254,191,1240,15.07%,11.34%,0.82,3.3,65,3,14,86,13,SEDANG
13/04/2020,DKI Jakarta,-55,-31,-53,-69,-50,25,135,7,1,127,1820,261,192,1367,14.34%,10.55%,0.87,0.21,40,2,8,46,9,BAIK
14/04/2020,DKI Jakarta,-55,-28,-53,-68,-51,24,122,10,0,112,1942,271,192,1479,13.95%,9.89%,0.9,1.43,48,4,8,51,10,SEDANG
15/04/2020,DKI Jakarta,-56,-30,-55,-68,-51,25,143,9,20,114,2085,280,212,1593,13.43%,10.17%,1.17,0.9,40,2,8,46,11,BAIK
16/04/2020,DKI Jakarta,-55,-29,-51,-69,-51,24,174,1,0,173,2259,281,212,1766,12.44%,9.38%,1.22,0.11,34,3,7,41,9,BAIK
17/04/2020,DKI Jakarta,-55,-28,-47,-70,-50,26,170,7,35,128,2429,288,247,1894,11.86%,10.17%,0.98,7,43,2,8,54,9,SEDANG
18/04/2020,DKI Jakarta,-62,-34,-59,-66,-37,20,101,7,1,93,2530,295,248,1987,11.66%,9.80%,0.59,1,43,4,5,72,7,SEDANG
19/04/2020,DKI Jakarta,-64,-36,-67,-67,-29,18,113,3,25,85,2643,298,273,2072,11.28%,10.33%,1.12,0.43,59,5,7,87,9,SEDANG
20/04/2020,DKI Jakarta,-56,-32,-53,-69,-49,24,74,5,7,62,2717,303,280,2134,11.15%,10.31%,0.65,1.67,60,3,5,73,7,SEDANG
21/04/2020,DKI Jakarta,-58,-33,-56,-69,-51,24,183,2,59,122,2900,305,339,2256,10.52%,11.69%,2.47,0.4,46,4,8,35,10,BAIK
22/04/2020,DKI Jakarta,-56,-31,-54,-67,-50,23,110,1,8,101,3010,306,347,2357,10.17%,11.53%,0.6,0.5,74,14,6,47,11,SEDANG
23/04/2020,DKI Jakarta,-54,-24,-52,-65,-50,22,122,0,4,118,3132,306,351,2475,9.77%,11.21%,1.11,0,45,5,5,43,7,BAIK
24/04/2020,DKI Jakarta,-64,-37,-59,-73,-55,29,78,0,1,77,3210,306,352,2552,9.53%,10.97%,0.64,1,43,4,3,27,8,BAIK
25/04/2020,DKI Jakarta,-65,-35,-63,-69,-41,22,78,19,7,52,3288,325,359,2604,9.88%,10.92%,1,,46,3,7,45,8,BAIK
26/04/2020,DKI Jakarta,-68,-43,-73,-72,-33,21,104,7,1,96,3392,332,360,2700,9.79%,10.61%,1.33,0.37,57,3,5,45,8,SEDANG
27/04/2020,DKI Jakarta,-60,-38,-58,-71,-50,26,66,13,1,52,3458,345,361,2752,9.98%,10.44%,0.63,1.86,36,1,4,71,8,SEDANG
28/04/2020,DKI Jakarta,-60,-34,-58,-70,-51,25,124,4,22,98,3582,349,383,2850,9.74%,10.69%,1.88,0.31,49,2,7,45,13,BAIK
29/04/2020,DKI Jakarta,-59,-35,-58,-70,-50,24,110,0,75,35,3692,349,458,2885,9.45%,12.41%,0.89,0,53,4,6,52,11,SEDANG
30/04/2020,DKI Jakarta,-57,-28,-54,-68,-49,24,106,0,46,60,3798,349,504,2945,9.19%,13.27%,0.96,1,61,5,6,33,14,SEDANG
1/5/2020,DKI Jakarta,-61,-28,-54,-76,-70,32,135,4,2,129,3933,353,506,3074,8.98%,12.87%,1.27,,47,2,9,38,10,BAIK
2/5/2020,DKI Jakarta,-62,-29,-59,-67,-39,21,92,17,24,51,4025,370,530,3125,9.19%,13.17%,0.68,4.25,32,2,12,29,9,BAIK
3/5/2020,DKI Jakarta,-64,-34,-68,-68,-29,19,129,5,112,12,4154,375,642,3137,9.03%,15.45%,1.4,0.29,52,5,11,35,9,SEDANG
4/5/2020,DKI Jakarta,-56,-31,-54,-68,-48,24,80,8,3,69,4234,383,645,3206,9.05%,15.23%,0.62,1.6,50,4,4,30,8,BAIK
5/5/2020,DKI Jakarta,-57,-29,-54,-68,-50,24,132,1,66,65,4366,384,711,3271,8.80%,16.28%,1.65,0.13,51,7,7,34,9,SEDANG
6/5/2020,DKI Jakarta,-57,-31,-56,-68,-49,24,106,5,37,64,4472,389,748,3335,8.70%,16.73%,0.8,5,44,4,4,29,7,BAIK
7/5/2020,DKI Jakarta,-61,-29,-94,-73,-70,30,82,8,4,70,4554,397,752,3405,8.72%,16.51%,0.77,1.6,50,4,3,48,9,BAIK
8/5/2020,DKI Jakarta,-56,-24,-94,-65,-48,26,96,1,0,95,4650,398,752,3500,8.56%,16.17%,1.17,0.13,60,4,4,60,10,SEDANG
9/5/2020,DKI Jakarta,-60,-25,-95,-62,-36,20,98,3,5,90,4748,401,757,3590,8.45%,15.94%,1.02,3,56,4,3,34,12,SEDANG
10/5/2020,DKI Jakarta,-63,-31,-96,-64,-28,19,125,6,49,70,4873,407,806,3660,8.35%,16.54%,1.28,2,64,5,3,44,12,SEDANG
11/5/2020,DKI Jakarta,-52,-21,-94,-63,-46,24,81,6,9,66,4954,413,815,3726,8.34%,16.45%,0.65,1,44,2,4,47,8,BAIK
12/5/2020,DKI Jakarta,-55,-24,-94,-64,-49,24,96,2,108,-14,5050,415,923,3712,8.22%,18.28%,1.19,0.33,47,3,4,62,10,SEDANG
13/05/2020,DKI Jakarta,-54,-22,-94,-63,-48,24,180,6,96,78,5230,421,1019,3790,8.05%,19.48%,1.88,3,54,2,3,38,8,SEDANG
14/05/2020,DKI Jakarta,-53,-20,-92,-64,-48,23,135,2,134,-1,5365,423,1153,3789,7.88%,21.49%,0.75,0.33,56,7,9,42,9,SEDANG
15/05/2020,DKI Jakarta,-50,-14,-91,-65,-46,23,86,7,106,-27,5451,430,1259,3762,7.89%,23.10%,0.64,3.5,60,7,7,40,9,SEDANG
16/05/2020,DKI Jakarta,-54,-14,-93,-60,-33,18,101,0,18,83,5552,430,1277,3845,7.74%,23.00%,1.17,0,58,6,8,57,8,SEDANG
17/05/2020,DKI Jakarta,-56,-18,-94,-62,-24,17,127,3,11,113,5679,433,1288,3958,7.62%,22.68%,1.26,,60,6,8,83,7,SEDANG
18/05/2020,DKI Jakarta,-51,-22,-92,-64,-46,23,79,0,0,79,5758,433,1288,4037,7.52%,22.37%,0.62,0,54,4,6,43,10,SEDANG
19/05/2020,DKI Jakarta,-47,-8,-92,-61,-47,22,94,7,21,66,5852,440,1309,4103,7.52%,22.37%,1.19,,30,8,8,59,13,SEDANG
20/05/2020,DKI Jakarta,-48,-14,-91,-61,-47,22,84,1,3,80,5936,441,1312,4183,7.43%,22.10%,0.89,0.14,50,12,10,34,8,BAIK
21/05/2020,DKI Jakarta,-46,-1,-90,-65,-69,26,70,8,130,-68,6006,449,1442,4115,7.48%,24.01%,0.83,8,27,7,7,49,9,BAIK
22/05/2020,DKI Jakarta,-46,-4,-90,-63,-60,27,106,29,55,22,6112,478,1497,4137,7.82%,24.49%,1.51,3.63,58,8,7,42,8,SEDANG
23/05/2020,DKI Jakarta,-54,-6,-92,-57,-48,19,111,1,54,56,6223,479,1551,4193,7.70%,24.92%,1.05,0.03,42,3,10,52,8,SEDANG
24/05/2020,DKI Jakarta,-65,-34,-93,-61,-37,13,112,0,20,92,6335,479,1571,4285,7.56%,24.80%,1.01,0,41,3,8,43,5,BAIK
25/05/2020,DKI Jakarta,-59,-28,-91,-73,-78,26,76,0,65,11,6411,479,1636,4296,7.47%,25.52%,0.68,1,26,2,4,27,5,BAIK
26/05/2020,DKI Jakarta,-54,-21,-91,-66,-58,23,87,0,13,74,6498,479,1649,4370,7.37%,25.38%,1.14,1,32,4,5,29,8,BAIK
27/05/2020,DKI Jakarta,-52,-21,-91,-65,-52,23,109,8,16,85,6607,487,1665,4455,7.37%,25.20%,1.25,,22,4,4,65,8,SEDANG
28/05/2020,DKI Jakarta,-50,-17,-91,-64,-49,22,100,0,20,80,6707,487,1685,4535,7.26%,25.12%,0.92,0,44,5,6,90,16,SEDANG
29/05/2020,DKI Jakarta,-49,-16,-90,-64,-47,24,125,0,38,87,6832,487,1723,4622,7.13%,25.22%,1.25,1,58,8,6,74,12,SEDANG
30/05/2020,DKI Jakarta,-54,-18,-91,-60,-33,17,108,7,255,-154,6940,494,1978,4468,7.12%,28.50%,0.86,,52,16,7,41,10,SEDANG
31/05/2020,DKI Jakarta,-56,-23,-93,-60,-22,15,113,1,70,42,7053,495,2048,4510,7.02%,29.04%,1.05,0.14,48,14,7,46,9,BAIK
1/6/2020,DKI Jakarta,-51,-18,-90,-69,-68,27,157,2,185,-30,7210,497,2233,4480,6.89%,30.97%,1.39,2,50,14,10,45,9,BAIK
2/6/2020,DKI Jakarta,-46,-14,-91,-58,-41,19,59,0,120,-61,7269,497,2353,4419,6.84%,32.37%,0.38,0,44,14,7,37,8,BAIK
3/6/2020,DKI Jakarta,-47,-16,-91,-59,-42,20,91,5,181,-95,7360,502,2534,4324,6.82%,34.43%,1.54,,41,14,4,31,8,BAIK
4/6/2020,DKI Jakarta,-46,-14,-90,-59,-41,20,109,0,21,88,7469,502,2555,4412,6.72%,34.21%,1.2,0,45,18,4,28,8,BAIK
5/6/2020,DKI Jakarta,-44,-13,-88,-58,-38,21,70,1,138,-69,7539,503,2693,4343,6.67%,35.72%,0.64,,56,18,6,60,12,SEDANG
6/6/2020,DKI Jakarta,-48,-13,-90,-55,-27,15,117,0,86,31,7656,503,2779,4374,6.57%,36.30%,1.67,0,69,18,7,74,13,SEDANG
7/6/2020,DKI Jakarta,-52,-18,-91,-56,-20,14,168,4,287,-123,7824,507,3066,4251,6.48%,39.19%,1.44,,55,16,5,65,9,SEDANG
8/6/2020,DKI Jakarta,-41,-14,-88,-53,-35,18,90,0,75,15,7914,507,3141,4266,6.41%,39.69%,0.54,0,59,15,5,33,10,SEDANG
9/6/2020,DKI Jakarta,-44,-16,-89,-54,-37,18,239,4,163,72,8153,511,3304,4338,6.27%,40.52%,2.66,,58,14,6,41,12,SEDANG
10/6/2020,DKI Jakarta,-42,-15,-89,-53,-36,18,166,2,141,23,8319,513,3445,4361,6.17%,41.41%,0.69,0.5,67,16,10,34,10,SEDANG
11/6/2020,DKI Jakarta,-41,-16,-87,-54,-37,18,131,1,147,-17,8450,514,3592,4344,6.08%,42.51%,0.79,0.5,63,16,6,40,10,SEDANG
12/6/2020,DKI Jakarta,-38,-13,-85,-54,-35,19,92,4,118,-30,8542,518,3710,4314,6.06%,43.43%,0.7,4,49,15,6,58,13,SEDANG
13/06/2020,DKI Jakarta,-44,-14,-86,-51,-23,14,121,8,58,55,8663,526,3768,4369,6.07%,43.50%,1.32,2,60,16,6,61,10,SEDANG
14/06/2020,DKI Jakarta,-47,-18,-87,-51,-17,13,118,9,246,-137,8781,535,4014,4232,6.09%,45.71%,0.98,1.13,60,15,6,61,12,SEDANG
15/06/2020,DKI Jakarta,-33,-12,-85,-49,-33,16,141,2,111,28,8922,537,4125,4260,6.02%,46.23%,1.19,0.22,70,13,8,54,13,SEDANG
16/06/2020,DKI Jakarta,-35,-13,-86,-49,-35,16,97,0,132,-35,9019,537,4257,4225,5.95%,47.20%,0.69,0,67,16,8,35,11,SEDANG
17/06/2020,DKI Jakarta,-35,-13,-86,-49,-34,16,122,5,115,2,9141,542,4372,4227,5.93%,47.83%,1.26,,56,15,5,49,8,SEDANG
18/06/2020,DKI Jakarta,-34,-14,-85,-50,-35,16,171,30,130,11,9312,572,4502,4238,6.14%,48.35%,1.4,6,60,17,6,56,9,SEDANG
19/06/2020,DKI Jakarta,-33,-13,-83,-49,-33,17,133,1,126,6,9445,573,4628,4244,6.07%,49.00%,0.78,0.03,57,15,6,47,11,SEDANG
20/06/2020,DKI Jakarta,-37,-12,-83,-45,-21,11,189,8,123,58,9634,581,4751,4302,6.03%,49.31%,1.42,8,61,17,12,67,17,SEDANG
21/06/2020,DKI Jakarta,-40,-16,-85,-45,-16,12,141,1,234,-94,9775,582,4985,4208,5.95%,51.00%,0.75,0.13,63,16,6,61,10,SEDANG
22/06/2020,DKI Jakarta,-31,-13,-84,-48,-34,16,123,0,75,48,9898,582,5060,4256,5.88%,51.12%,0.87,0,67,20,6,34,11,SEDANG
23/06/2020,DKI Jakarta,-33,-13,-85,-48,-35,16,160,8,109,43,10058,590,5169,4299,5.87%,51.39%,1.3,,53,18,7,41,15,SEDANG
24/06/2020,DKI Jakarta,-33,-15,-85,-47,-34,16,152,8,97,47,10210,598,5266,4346,5.86%,51.58%,0.95,1,53,15,7,77,11,SEDANG
25/06/2020,DKI Jakarta,-31,-9,-84,-47,-34,15,181,9,220,-48,10391,607,5486,4298,5.84%,52.80%,1.19,1.13,76,19,13,64,23,SEDANG
26/06/2020,DKI Jakarta,-28,-6,-83,-46,-32,16,197,4,0,193,10588,611,5486,4491,5.77%,51.81%,1.09,0.44,70,18,10,61,19,SEDANG
27/06/2020,DKI Jakarta,-32,-6,-82,-40,-21,10,192,8,68,116,10780,619,5554,4607,5.74%,51.52%,0.97,2,65,20,6,42,14,SEDANG
28/06/2020,DKI Jakarta,-38,-12,-83,-43,-15,10,132,1,255,-124,10912,620,5809,4483,5.68%,53.23%,0.69,0.13,72,21,6,47,11,SEDANG
29/06/2020,DKI Jakarta,-28,-7,-83,-45,-32,14,122,0,252,-130,11034,620,6061,4353,5.62%,54.93%,0.92,0,68,20,5,57,11,SEDANG
30/06/2020,DKI Jakarta,-27,-3,-77,-45,-33,14,182,8,394,-220,11216,628,6455,4133,5.60%,57.55%,1.49,,75,20,6,53,15,SEDANG
1/7/2020,DKI Jakarta,-27,-4,-77,-44,-33,14,215,0,168,47,11431,628,6623,4180,5.49%,57.94%,1.18,0,69,18,6,65,11,SEDANG
2/7/2020,DKI Jakarta,-30,-8,-77,-45,-34,15,200,6,192,2,11631,634,6815,4182,5.45%,58.59%,0.93,,68,17,7,47,11,SEDANG
3/7/2020,DKI Jakarta,-24,-3,-72,-43,-32,15,140,5,240,-105,11771,639,7055,4077,5.43%,59.94%,0.7,0.83,54,18,7,32,9,SEDANG
4/7/2020,DKI Jakarta,-29,-4,-73,-38,-21,10,218,0,268,-50,11989,639,7323,4027,5.33%,61.08%,1.56,0,70,18,8,43,12,SEDANG
5/7/2020,DKI Jakarta,-33,-9,-75,-39,-17,9,255,5,286,-36,12244,644,7609,3991,5.26%,62.14%,1.17,,63,20,5,40,9,SEDANG
6/7/2020,DKI Jakarta,-25,-6,-75,-43,-32,14,221,0,374,-153,12465,644,7983,3838,5.17%,64.04%,0.87,0,58,21,7,39,12,SEDANG
7/7/2020,DKI Jakarta,-26,-6,-76,-42,-33,14,193,12,242,-61,12658,656,8225,3777,5.18%,64.98%,0.87,,53,22,6,33,12,SEDANG
8/7/2020,DKI Jakarta,-27,-9,-76,-43,-32,14,350,6,147,197,13008,662,8372,3974,5.09%,64.36%,1.81,0.5,60,20,6,59,15,SEDANG
9/7/2020,DKI Jakarta,-27,-8,-75,-43,-32,14,277,6,223,48,13285,668,8595,4022,5.03%,64.70%,0.79,1,54,16,8,67,12,SEDANG
10/7/2020,DKI Jakarta,-24,-6,-71,-43,-30,15,252,0,180,72,13537,668,8775,4094,4.93%,64.82%,0.91,0,62,19,8,80,17,SEDANG
11/7/2020,DKI Jakarta,-29,-6,-72,-38,-19,10,383,10,215,158,13920,678,8990,4252,4.87%,64.58%,1.52,,73,17,9,47,16,SEDANG
12/7/2020,DKI Jakarta,-33,-10,-75,-39,-15,9,395,10,159,226,14315,688,9149,4478,4.81%,63.91%,1.03,1,62,17,6,60,9,SEDANG
13/07/2020,DKI Jakarta,-26,-8,-74,-44,-31,14,281,7,208,66,14596,695,9357,4544,4.76%,64.11%,0.71,0.7,61,19,5,44,10,SEDANG
14/07/2020,DKI Jakarta,-29,-11,-76,-44,-33,15,266,4,120,142,14862,699,9477,4686,4.70%,63.77%,0.95,0.57,64,21,6,55,16,SEDANG
15/07/2020,DKI Jakarta,-28,-12,-75,-44,-32,15,251,5,197,49,15113,704,9674,4735,4.66%,64.01%,0.94,1.25,57,16,6,31,12,SEDANG
16/07/2020,DKI Jakarta,-28,-10,-73,-43,-31,15,309,8,135,166,15422,712,9809,4901,4.62%,63.60%,1.23,1.6,48,19,5,24,11,BAIK
17/07/2020,DKI Jakarta,-25,-8,-69,-43,-30,15,257,6,139,112,15679,718,9948,5013,4.58%,63.45%,0.83,0.75,56,24,7,39,10,SEDANG
18/07/2020,DKI Jakarta,-29,-7,-69,-38,-19,10,339,8,121,210,16018,726,10069,5223,4.53%,62.86%,1.32,1.33,55,21,7,54,15,SEDANG
19/07/2020,DKI Jakarta,-33,-11,-72,-39,-14,10,319,9,327,-17,16337,735,10396,5206,4.50%,63.63%,0.94,1.13,68,17,6,66,10,SEDANG
20/07/2020,DKI Jakarta,-27,-9,-72,-43,-31,15,381,9,155,217,16718,744,10551,5423,4.45%,63.11%,1.19,1,66,16,8,77,12,SEDANG
21/07/2020,DKI Jakarta,-30,-12,-73,-43,-33,15,432,8,266,158,17150,752,10817,5581,4.38%,63.07%,1.13,0.89,59,19,8,58,12,SEDANG
22/07/2020,DKI Jakarta,-29,-13,-73,-44,-31,15,387,5,367,15,17537,757,11184,5596,4.32%,63.77%,0.9,0.63,56,16,6,49,15,SEDANG
23/07/2020,DKI Jakarta,-29,-12,-72,-45,-31,15,462,2,168,292,17999,759,11352,5888,4.22%,63.07%,1.19,0.4,62,16,7,85,11,SEDANG
24/07/2020,DKI Jakarta,-24,-6,-67,-42,-29,15,293,4,270,19,18292,763,11622,5907,4.17%,63.54%,0.63,2,60,18,7,56,13,SEDANG
25/07/2020,DKI Jakarta,-26,-3,-68,-35,-19,10,369,0,175,194,18661,763,11797,6101,4.09%,63.22%,1.26,0,64,18,7,60,11,SEDANG
26/07/2020,DKI Jakarta,-32,-9,-72,-37,-14,9,384,4,161,219,19045,767,11958,6320,4.03%,62.79%,1.04,,59,19,5,45,10,SEDANG
27/07/2020,DKI Jakarta,-26,-8,-71,-42,-31,14,501,10,112,379,19546,777,12070,6699,3.98%,61.75%,1.3,2.5,58,21,6,56,11,SEDANG
28/07/2020,DKI Jakarta,-27,-6,-73,-41,-32,14,409,16,374,19,19955,793,12444,6718,3.97%,62.36%,0.82,1.6,68,20,7,89,14,SEDANG
29/07/2020,DKI Jakarta,-26,-6,-73,-39,-33,14,617,14,250,353,20572,807,12694,7071,3.92%,61.71%,1.51,0.88,66,19,7,107,14,TIDAK SEHAT
30/07/2020,DKI Jakarta,-23,4,-64,-35,-34,11,397,19,188,190,20969,826,12882,7261,3.94%,61.43%,0.64,1.36,68,17,7,104,12,TIDAK SEHAT
31/07/2020,DKI Jakarta,-41,-21,-64,-60,-71,23,430,14,405,11,21399,840,13287,7272,3.93%,62.09%,1.08,0.74,56,19,7,62,14,SEDANG
1/8/2020,DKI Jakarta,-37,-14,-69,-45,-31,10,368,12,680,-324,21767,852,13967,6948,3.91%,64.17%,0.86,0.86,65,18,7,84,13,SEDANG
2/8/2020,DKI Jakarta,-37,-14,-71,-40,-19,7,377,0,141,236,22144,852,14108,7184,3.85%,63.71%,1.02,0,75,17,11,77,15,SEDANG
3/8/2020,DKI Jakarta,-27,-7,-69,-42,-33,13,472,16,134,322,22616,868,14242,7506,3.84%,62.97%,1.25,,71,18,9,65,11,SEDANG
4/8/2020,DKI Jakarta,-28,-8,-70,-42,-34,14,410,14,224,172,23026,882,14466,7678,3.83%,62.82%,0.87,0.88,61,19,5,61,11,SEDANG
5/8/2020,DKI Jakarta,-27,-9,-68,-42,-33,14,354,14,379,-39,23380,896,14845,7639,3.83%,63.49%,0.86,1,67,20,7,70,12,SEDANG
6/8/2020,DKI Jakarta,-27,-8,-66,-42,-33,14,556,13,248,295,23936,909,15093,7934,3.80%,63.06%,1.57,0.93,70,23,6,55,16,SEDANG
7/8/2020,DKI Jakarta,-23,-6,-61,-41,-31,14,665,12,196,457,24601,921,15289,8391,3.74%,62.15%,1.2,0.92,65,19,6,72,12,SEDANG
8/8/2020,DKI Jakarta,-27,-6,-62,-33,-20,9,686,11,509,166,25287,932,15798,8557,3.69%,62.47%,1.03,0.92,64,18,6,58,14,SEDANG
9/8/2020,DKI Jakarta,-32,-11,-66,-35,-15,8,440,6,560,-126,25727,938,16358,8431,3.65%,63.58%,0.64,0.55,54,15,6,65,12,SEDANG
10/8/2020,DKI Jakarta,-25,-7,-65,-41,-32,14,433,2,179,252,26160,940,16537,8683,3.59%,63.21%,0.98,0.33,58,18,5,47,11,SEDANG
11/8/2020,DKI Jakarta,-28,-10,-68,-41,-33,14,462,12,184,266,26622,952,16721,8949,3.58%,62.81%,1.07,6,60,20,5,34,10,SEDANG
12/8/2020,DKI Jakarta,-26,-10,-63,-41,-32,14,529,15,822,-308,27151,967,17543,8641,3.56%,64.61%,1.15,1.25,68,19,14,49,17,SEDANG
13/08/2020,DKI Jakarta,-32,-16,-65,-43,-33,15,608,11,400,197,27759,978,17943,8838,3.52%,64.64%,1.15,0.73,53,16,7,41,12,SEDANG
14/08/2020,DKI Jakarta,-23,-5,-56,-38,-31,14,538,4,694,-160,28297,982,18637,8678,3.47%,65.86%,0.88,0.36,40,16,8,43,16,BAIK
15/08/2020,DKI Jakarta,-28,-6,-58,-32,-20,8,583,6,527,50,28880,988,19164,8728,3.42%,66.36%,1.08,1.5,58,18,10,29,12,SEDANG
16/08/2020,DKI Jakarta,-33,-14,-62,-36,-15,8,518,1,654,-137,29398,989,19818,8591,3.36%,67.41%,0.89,0.17,50,19,4,44,10,BAIK
17/08/2020,DKI Jakarta,-32,-19,-49,-57,-70,21,552,14,209,329,29950,1003,20027,8920,3.35%,66.87%,1.07,14,52,16,7,52,10,SEDANG
18/08/2020,DKI Jakarta,-31,-14,-64,-42,-32,13,513,19,589,-95,30463,1022,20616,8825,3.35%,67.68%,0.93,1.36,52,17,10,66,13,SEDANG
19/08/2020,DKI Jakarta,-26,-8,-63,-39,-32,12,551,18,570,-37,31014,1040,21186,8788,3.35%,68.31%,1.07,0.95,65,18,15,39,18,SEDANG
20/08/2020,DKI Jakarta,-32,-16,-55,-55,-65,20,594,16,729,-151,31608,1056,21915,8637,3.34%,69.33%,1.08,0.89,54,17,6,40,13,SEDANG
21/08/2020,DKI Jakarta,-29,-14,-56,-52,-47,18,657,16,435,206,32265,1072,22350,8843,3.32%,69.27%,1.11,1,46,18,3,41,9,BAIK
22/08/2020,DKI Jakarta,-32,-15,-57,-40,-20,9,588,17,653,-82,32853,1089,23003,8761,3.31%,70.02%,0.89,1.06,58,21,5,42,11,SEDANG
23/08/2020,DKI Jakarta,-35,-18,-63,-38,-13,9,614,17,693,-96,33467,1106,23696,8665,3.30%,70.80%,1.04,1,63,22,7,53,13,SEDANG
24/08/2020,DKI Jakarta,-27,-12,-61,-41,-30,14,633,16,1901,-1284,34100,1122,25597,7381,3.29%,75.06%,1.03,0.94,55,18,5,44,11,SEDANG
25/08/2020,DKI Jakarta,-26,-7,-62,-40,-31,14,638,15,526,97,34738,1137,26123,7478,3.27%,75.20%,1.01,0.94,57,20,7,53,14,SEDANG
26/08/2020,DKI Jakarta,-26,-9,-62,-41,-30,14,713,7,764,-58,35451,1144,26887,7420,3.23%,75.84%,1.12,0.47,52,20,5,66,11,SEDANG
27/08/2020,DKI Jakarta,-25,-8,-60,-41,-30,13,760,11,1539,-790,36211,1155,28426,6630,3.19%,78.50%,1.07,1.57,55,18,5,52,11,SEDANG
28/08/2020,DKI Jakarta,-21,-3,-56,-40,-29,14,869,10,880,-21,37080,1165,29306,6609,3.14%,79.03%,1.14,0.91,57,19,5,48,16,SEDANG
29/08/2020,DKI Jakarta,-25,-2,-56,-33,-17,8,861,18,600,243,37941,1183,29906,6852,3.12%,78.82%,0.99,1.8,59,20,4,54,8,SEDANG
30/08/2020,DKI Jakarta,-28,-7,-60,-33,-12,8,1094,9,368,717,39035,1192,30274,7569,3.05%,77.56%,1.27,0.5,56,19,4,58,6,SEDANG
31/08/2020,DKI Jakarta,-23,-3,-61,-40,-30,13,1049,14,402,633,40084,1206,30676,8202,3.01%,76.53%,0.96,1.56,57,20,6,68,14,SEDANG
1/9/2020,DKI Jakarta,-24,-2,-61,-39,-31,13,901,17,737,147,40985,1223,31413,8349,2.98%,76.65%,0.86,1.21,63,20,6,60,11,SEDANG
2/9/2020,DKI Jakarta,-25,-6,-62,-40,-31,13,1054,17,479,558,42039,1240,31892,8907,2.95%,75.86%,1.17,1,57,18,6,81,13,SEDANG
3/9/2020,DKI Jakarta,-25,-6,-58,-42,-31,13,1359,15,702,642,43398,1255,32594,9549,2.89%,75.10%,1.29,0.88,58,18,8,65,13,SEDANG
4/9/2020,DKI Jakarta,-22,-5,-51,-41,-30,14,880,6,823,51,44278,1261,33417,9600,2.85%,75.47%,0.65,0.4,48,19,5,44,9,SEDANG
5/9/2020,DKI Jakarta,-25,-4,-53,-34,-19,8,877,14,731,132,45155,1275,34148,9732,2.82%,75.62%,1,2.33,50,17,5,88,12,SEDANG
6/9/2020,DKI Jakarta,-30,-10,-58,-34,-15,8,1176,10,805,361,46331,1285,34953,10093,2.77%,75.44%,1.34,0.71,59,17,7,84,12,SEDANG
7/9/2020,DKI Jakarta,-25,-8,-58,-41,-32,14,1046,22,662,362,47377,1307,35615,10455,2.76%,75.17%,0.89,2.2,---,23,6,64,12,SEDANG
8/9/2020,DKI Jakarta,-26,-9,-59,-40,-33,14,1014,21,931,62,48391,1328,36546,10517,2.74%,75.52%,0.97,0.95,58,22,5,47,12,SEDANG
9/9/2020,DKI Jakarta,-26,-10,-60,-41,-32,13,1004,17,844,143,49395,1345,37390,10660,2.72%,75.70%,0.99,0.81,56,22,4,39,9,SEDANG
10/9/2020,DKI Jakarta,-26,-10,-59,-42,-32,13,1274,17,1008,249,50669,1362,38398,10909,2.69%,75.78%,1.27,1,56,18,6,78,13,SEDANG
11/9/2020,DKI Jakarta,-22,-8,-52,-41,-30,14,964,17,904,43,51633,1379,39302,10952,2.67%,76.12%,0.76,1,68,18,7,70,22,SEDANG
12/9/2020,DKI Jakarta,-27,-8,-53,-35,-18,9,1205,18,665,522,52838,1397,39967,11474,2.64%,75.64%,1.25,1.06,59,18,7,99,18,SEDANG
13/09/2020,DKI Jakarta,-32,-14,-61,-36,-13,9,1380,5,957,418,54218,1402,40924,11892,2.59%,75.48%,1.15,0.28,60,18,7,86,11,SEDANG
14/09/2020,DKI Jakarta,-41,-24,-67,-54,-37,19,879,27,1511,-659,55097,1429,42435,11233,2.59%,77.02%,0.64,5.4,57,18,6,58,11,SEDANG
15/09/2020,DKI Jakarta,-42,-25,-69,-54,-38,19,1076,33,982,61,56173,1462,43417,11294,2.60%,77.29%,1.22,1.22,55,16,6,69,12,SEDANG
16/09/2020,DKI Jakarta,-38,-17,-65,-52,-37,18,1294,31,1146,117,57467,1493,44563,11411,2.60%,77.55%,1.2,0.94,57,16,7,59,14,SEDANG
17/09/2020,DKI Jakarta,-39,-18,-63,-53,-37,18,1113,14,748,351,58580,1507,45311,11762,2.57%,77.35%,0.86,0.45,45,18,4,49,10,SEDANG
18/09/2020,DKI Jakarta,-38,-17,-59,-52,-36,19,1258,22,1036,200,59838,1529,46347,11962,2.56%,77.45%,1.13,1.57,52,19,4,42,10,SEDANG
19/09/2020,DKI Jakarta,-41,-16,-65,-47,-21,13,988,10,1032,-54,60826,1539,47379,11908,2.53%,77.89%,0.79,0.45,60,22,5,68,11,SEDANG
20/09/2020,DKI Jakarta,-53,-30,-76,-55,-21,15,1138,14,1069,55,61964,1553,48448,11963,2.51%,78.19%,1.15,1.4,44,19,3,35,6,SEDANG
21/09/2020,DKI Jakarta,-40,-22,-66,-52,-37,18,1352,29,1294,29,63316,1582,49742,11992,2.50%,78.56%,1.19,2.07,46,18,8,64,9,SEDANG
22/09/2020,DKI Jakarta,-43,-21,-68,-53,-39,19,1236,30,849,357,64552,1612,50591,12349,2.50%,78.37%,0.91,1.03,37,15,6,82,11,SEDANG
23/09/2020,DKI Jakarta,-43,-19,-65,-51,-37,19,1135,28,1105,2,65687,1640,51696,12351,2.50%,78.70%,0.92,0.93,54,20,7,78,12,SEDANG
24/09/2020,DKI Jakarta,-44,-19,-64,-52,-37,18,1044,20,1162,-138,66731,1660,52858,12213,2.49%,79.21%,0.92,0.71,57,17,6,82,14,SEDANG
25/09/2020,DKI Jakarta,-40,-11,-59,-50,-36,19,1171,13,1626,-468,67902,1673,54484,11745,2.46%,80.24%,1.12,0.65,62,19,6,65,11,SEDANG
26/09/2020,DKI Jakarta,-43,-11,-65,-44,-21,13,1323,12,764,547,69225,1685,55248,12292,2.43%,79.81%,1.13,0.92,69,19,10,91,14,TIDAK SEHAT
27/09/2020,DKI Jakarta,-49,-19,-71,-47,-18,13,1217,13,1294,-90,70442,1698,56542,12202,2.41%,80.27%,0.92,1.08,61,17,11,77,13,SEDANG
28/09/2020,DKI Jakarta,-40,-13,-64,-50,-36,18,898,9,1331,-442,71340,1707,57873,11760,2.39%,81.12%,0.74,0.69,42,16,5,70,10,SEDANG
29/09/2020,DKI Jakarta,-42,-14,-63,-49,-37,18,1238,21,1121,96,72578,1728,58994,11856,2.38%,81.28%,1.38,2.33,52,19,6,66,11,SEDANG
30/09/2020,DKI Jakarta,-39,-8,-61,-47,-36,16,1159,13,1452,-306,73737,1741,60446,11550,2.36%,81.98%,0.94,0.62,55,19,6,47,11,SEDANG
1/10/2020,DKI Jakarta,-40,-6,-58,-47,-36,15,1253,6,1118,129,74990,1747,61564,11679,2.33%,82.10%,1.08,0.46,50,19,4,50,10,SEDANG
2/10/2020,DKI Jakarta,-38,-7,-53,-46,-35,16,1198,3,675,520,76188,1750,62239,12199,2.30%,81.69%,0.96,0.5,53,22,6,69,12,SEDANG
3/10/2020,DKI Jakarta,-41,-7,-60,-40,-23,11,1265,4,1190,71,77453,1754,63429,12270,2.26%,81.89%,1.06,1.33,50,17,9,71,14,SEDANG
4/10/2020,DKI Jakarta,-45,-14,-66,-41,-19,10,1398,13,1031,354,78851,1767,64460,12624,2.24%,81.75%,1.11,3.25,53,18,8,75,16,SEDANG
5/10/2020,DKI Jakarta,-38,-8,-58,-46,-36,14,1022,16,980,26,79873,1783,65440,12650,2.23%,81.93%,0.73,1.23,40,16,5,95,10,SEDANG
6/10/2020,DKI Jakarta,-40,-13,-61,-47,-37,15,1106,31,1016,59,80979,1814,66456,12709,2.24%,82.07%,1.08,1.94,42,17,5,70,11,SEDANG
7/10/2020,DKI Jakarta,-40,-14,-61,-48,-36,15,1211,15,987,209,82190,1829,67443,12918,2.23%,82.06%,1.09,0.48,52,20,5,68,13,SEDANG
8/10/2020,DKI Jakarta,-41,-16,-40,-41,-37,17,1182,17,1047,118,83372,1846,68490,13036,2.21%,82.15%,0.98,1.13,46,20,5,83,11,SEDANG
9/10/2020,DKI Jakarta,-40,-15,-57,-50,-36,19,943,21,849,73,84315,1867,69339,13109,2.21%,82.24%,0.8,1.24,60,18,7,87,14,SEDANG
10/10/2020,DKI Jakarta,-44,-17,-63,-43,-21,12,1259,16,1284,-41,85574,1883,70623,13068,2.20%,82.53%,1.34,0.76,53,17,7,60,11,SEDANG
11/10/2020,DKI Jakarta,-45,-16,-66,-43,-15,11,1389,18,1062,309,86963,1901,71685,13377,2.19%,82.43%,1.1,1.13,44,18,6,74,11,SEDANG
12/10/2020,DKI Jakarta,-36,-14,-56,-46,-33,16,1211,25,1113,73,88174,1926,72798,13450,2.18%,82.56%,0.87,1.39,57,19,7,86,16,SEDANG
13/10/2020,DKI Jakarta,-41,-18,-55,-48,-37,18,1054,19,1101,-66,89228,1945,73899,13384,2.18%,82.82%,0.87,0.76,61,21,9,75,11,SEDANG
14/10/2020,DKI Jakarta,-36,-16,-58,-46,-33,16,1038,17,1203,-182,90266,1962,75102,13202,2.17%,83.20%,0.98,0.89,63,18,8,63,20,SEDANG
15/10/2020,DKI Jakarta,-35,-13,-56,-44,-33,16,1072,20,1050,2,91338,1982,76152,13204,2.17%,83.37%,1.03,1.18,60,20,7,70,17,SEDANG
16/10/2020,DKI Jakarta,-38,-19,-55,-45,-33,18,1045,24,982,39,92383,2006,77134,13243,2.17%,83.49%,0.97,1.2,56,19,7,76,20,SEDANG
17/10/2020,DKI Jakarta,-34,-7,-54,-35,-18,10,974,23,1108,-157,93357,2029,78242,13086,2.17%,83.81%,0.93,0.96,51,17,9,61,22,SEDANG
18/10/2020,DKI Jakarta,-38,-15,-58,-35,-15,10,971,17,1080,-126,94328,2046,79322,12960,2.17%,84.09%,1,0.74,50,16,7,51,14,SEDANG
19/10/2020,DKI Jakarta,-36,-16,-60,-42,-33,16,926,14,1128,-216,95254,2060,80450,12744,2.16%,84.46%,0.95,0.82,54,16,7,60,11,SEDANG
20/10/2020,DKI Jakarta,-37,-17,-54,-42,-34,16,964,22,837,105,96218,2082,81287,12849,2.16%,84.48%,1.04,1.57,54,18,11,43,15,SEDANG
21/10/2020,DKI Jakarta,-38,-21,-61,-44,-33,16,1000,21,1073,-94,97218,2103,82360,12755,2.16%,84.72%,1.04,0.95,57,18,11,71,15,SEDANG
22/10/2020,DKI Jakarta,-33,-10,-49,-41,-33,14,989,16,1157,-184,98207,2119,83517,12571,2.16%,85.04%,0.99,0.76,48,17,10,44,13,SEDANG
23/10/2020,DKI Jakarta,-29,-6,-46,-40,-31,14,952,21,1093,-162,99159,2140,84610,12409,2.16%,85.33%,0.96,1.31,26,15,3,23,7,BAIK
24/10/2020,DKI Jakarta,-32,-6,-49,-31,-17,9,1062,20,1157,-115,100221,2160,85767,12294,2.16%,85.58%,1.12,0.95,47,23,6,61,11,SEDANG
25/10/2020,DKI Jakarta,-36,-12,-55,-33,-14,8,771,18,1231,-478,100992,2178,86998,11816,2.16%,86.14%,0.73,0.9,39,17,7,48,11,SEDANG
26/10/2020,DKI Jakarta,-36,-16,-58,-41,-32,14,906,13,1185,-292,101898,2191,88183,11524,2.15%,86.54%,1.18,0.72,41,18,8,77,20,SEDANG
27/10/2020,DKI Jakarta,-32,-8,-57,-36,-33,13,781,11,1130,-360,102679,2202,89313,11164,2.14%,86.98%,0.86,0.85,40,16,9,77,15,SEDANG
28/10/2020,DKI Jakarta,-28,-4,-45,-40,-45,13,844,17,1060,-233,103523,2219,90373,10931,2.14%,87.30%,1.08,1.55,55,18,18,60,16,SEDANG
29/10/2020,DKI Jakarta,-32,-13,-38,-50,-65,17,713,14,1084,-385,104236,2233,91457,10546,2.14%,87.74%,0.84,0.82,51,17,7,40,14,SEDANG
30/10/2020,DKI Jakarta,-33,-13,-44,-50,-49,17,612,14,1081,-483,104848,2247,92538,10063,2.14%,88.26%,0.86,1,52,18,5,35,9,SEDANG
31/10/2020,DKI Jakarta,-40,-20,-54,-39,-23,9,750,19,1047,-316,105598,2266,93585,9747,2.15%,88.62%,1.23,1.36,35,20,3,48,8,SEDANG
1/11/2020,DKI Jakarta,-38,-15,-55,-31,-16,6,608,19,1474,-885,106206,2285,95059,8862,2.15%,89.50%,0.81,1,49,67,18,10,40,SEDANG
2/11/2020,DKI Jakarta,-30,-7,-52,-37,-31,12,1024,18,1058,-52,107230,2303,96117,8810,2.15%,89.64%,1.68,0.95,23,27,15,3,32,BAIK
3/11/2020,DKI Jakarta,-31,-9,-56,-39,-32,13,617,10,1025,-418,107847,2313,97142,8392,2.14%,90.07%,0.6,0.56,43,64,19,6,53,SEDANG
4/11/2020,DKI Jakarta,-31,-12,-56,-40,-32,13,768,14,940,-186,108615,2327,98082,8206,2.14%,90.30%,1.24,1.4,42,62,20,5,59,SEDANG
5/11/2020,DKI Jakarta,-33,-14,-57,-42,-33,14,797,15,974,-192,109412,2342,99056,8014,2.14%,90.53%,1.04,1.07,51,70,17,11,50,SEDANG
6/11/2020,DKI Jakarta,-28,-9,-49,-40,-31,14,672,18,1028,-374,110084,2360,100084,7640,2.14%,90.92%,0.84,1.2,79,106,23,13,49,TIDAK SEHAT
7/11/2020,DKI Jakarta,-29,-8,-47,-31,-18,8,1118,11,987,120,111202,2371,101071,7760,2.13%,90.89%,1.66,0.61,61,85,19,14,45,SEDANG
8/11/2020,DKI Jakarta,-33,-13,-51,-32,-14,7,826,8,984,-166,112028,2379,102055,7594,2.12%,91.10%,0.74,0.73,60,85,16,17,57,SEDANG
9/11/2020,DKI Jakarta,-30,-11,-54,-40,-31,13,716,12,1131,-427,112744,2391,103186,7167,2.12%,91.52%,0.87,1.5,62,95,20,13,57,SEDANG
10/11/2020,DKI Jakarta,-32,-12,-53,-39,-33,13,1013,13,1257,-257,113757,2404,104443,6910,2.11%,91.81%,1.41,1.08,62,92,18,8,53,SEDANG
11/11/2020,DKI Jakarta,-29,-11,-53,-40,-31,13,587,13,959,-385,114344,2417,105402,6525,2.11%,92.18%,0.58,1,61,97,20,10,62,SEDANG
12/11/2020,DKI Jakarta,-30,-12,-52,-40,-32,13,831,11,1072,-252,115175,2428,106474,6273,2.11%,92.45%,1.42,0.85,53,80,20,6,49,SEDANG
13/11/2020,DKI Jakarta,-26,-9,-44,-38,-30,13,1033,10,13,1010,116208,2438,106487,7283,2.10%,91.63%,1.24,0.91,53,68,20,5,34,SEDANG
14/11/2020,DKI Jakarta,-28,-8,-45,-30,-17,7,1255,5,11,1239,117463,2443,106498,8522,2.08%,90.67%,1.21,0.5,54,78,20,7,79,SEDANG
15/11/2020,DKI Jakarta,-31,-12,-46,-30,-13,7,1164,2,23,1139,118627,2445,106521,9661,2.06%,89.79%,0.93,0.4,52,73,21,6,41,SEDANG
16/11/2020,DKI Jakarta,-31,-12,-53,-40,-31,13,1006,2,867,137,119633,2447,107388,9798,2.05%,89.76%,0.86,1,51,70,20,5,42,SEDANG
17/11/2020,DKI Jakarta,-32,-13,-54,-40,-32,13,1037,36,825,176,120670,2483,108213,9974,2.06%,89.68%,1.03,18,57,84,18,7,60,SEDANG
18/11/2020,DKI Jakarta,-32,-14,-54,-41,-31,13,1148,11,2193,-1056,121818,2494,110406,8918,2.05%,90.63%,1.11,0.31,57,79,18,9,71,SEDANG
19/11/2020,DKI Jakarta,-30,-12,-51,-41,-31,13,1185,14,2671,-1500,123003,2508,113077,7418,2.04%,91.93%,1.03,1.27,58,84,18,13,64,SEDANG
20/11/2020,DKI Jakarta,-27,-9,-44,-40,-30,14,1240,0,569,671,124243,2508,113646,8089,2.02%,91.47%,1.05,0,53,68,20,5,34,SEDANG
21/11/2020,DKI Jakarta,-29,-9,-48,-32,-17,8,1579,15,1085,479,125822,2523,114731,8568,2.01%,91.19%,1.27,,54,82,18,15,48,SEDANG
22/11/2020,DKI Jakarta,-33,-14,-51,-32,-14,8,1342,16,1070,256,127164,2539,115801,8824,2.00%,91.06%,0.85,1.07,51,69,18,15,45,SEDANG
23/11/2020,DKI Jakarta,-32,-15,-55,-42,-31,13,1009,3,1052,-46,128173,2542,116853,8778,1.98%,91.17%,0.75,0.19,62,93,20,11,51,SEDANG
24/11/2020,DKI Jakarta,-35,-18,-57,-41,-32,14,1015,19,1089,-93,129188,2561,117942,8685,1.98%,91.29%,1.01,6.33,44,56,19,8,53,SEDANG
25/11/2020,DKI Jakarta,-28,-9,-52,-39,-31,12,1273,17,1090,166,130461,2578,119032,8851,1.98%,91.24%,1.25,0.89,39,63,19,8,48,SEDANG
26/11/2020,DKI Jakarta,-25,-5,-46,-37,-31,11,1064,14,1133,-83,131525,2592,120165,8768,1.97%,91.36%,0.84,0.82,47,69,21,9,55,SEDANG
27/11/2020,DKI Jakarta,-25,-8,-43,-38,-30,13,1436,15,838,583,132961,2607,121003,9351,1.96%,91.01%,1.35,1.07,44,59,20,8,41,SEDANG
28/11/2020,DKI Jakarta,-23,1,-41,-27,-17,6,1370,15,1232,123,134331,2622,122235,9474,1.95%,91.00%,0.95,1,46,66,18,7,65,SEDANG
29/11/2020,DKI Jakarta,-29,-9,-49,-29,-13,6,1431,19,820,592,135762,2641,123055,10066,1.95%,90.64%,1.04,1.27,37,56,17,7,24,SEDANG
30/11/2020,DKI Jakarta,-24,0,-48,-37,-30,11,1099,25,910,164,136861,2666,123965,10230,1.95%,90.58%,0.77,1.32,18,21,16,4,27,BAIK
1/12/2020,DKI Jakarta,-24,1,-47,-36,-31,11,1058,23,1042,-7,137919,2689,125007,10223,1.95%,90.64%,0.96,0.92,22,17,4,19,8,BAIK
2/12/2020,DKI Jakarta,-24,-3,-47,-38,-30,12,1166,23,1063,80,139085,2712,126070,10303,1.95%,90.64%,1.1,1,25,18,4,28,7,BAIK
3/12/2020,DKI Jakarta,-26,-6,-48,-40,-32,12,1153,34,1073,46,140238,2746,127143,10349,1.96%,90.66%,0.99,1.48,29,19,8,48,14,BAIK
4/12/2020,DKI Jakarta,-23,-2,-43,-37,-30,12,1032,23,928,81,141270,2769,128071,10430,1.96%,90.66%,0.9,0.68,39,29,8,52,17,SEDANG
5/12/2020,DKI Jakarta,-25,-2,-44,-27,-18,6,1360,23,1031,306,142630,2792,129102,10736,1.96%,90.52%,1.32,1,28,22,7,34,11,BAIK
6/12/2020,DKI Jakarta,-33,-13,-59,-33,-16,8,1331,23,1040,268,143961,2815,130142,11004,1.96%,90.40%,0.98,1,31,22,7,30,9,BAIK
7/12/2020,DKI Jakarta,-28,-9,-54,-40,-33,12,1466,24,944,498,145427,2839,131086,11502,1.95%,90.14%,1.1,1.04,25,22,6,18,9,BAIK
8/12/2020,DKI Jakarta,-26,-6,-51,-37,-31,11,1194,21,1203,-30,146621,2860,132289,11472,1.95%,90.23%,0.81,0.88,36,31,8,23,8,SEDANG
9/12/2020,DKI Jakarta,-26,-9,-44,-49,-59,19,1217,18,1072,127,147838,2878,133361,11599,1.95%,90.21%,1.02,0.86,32,22,5,25,8,BAIK
10/12/2020,DKI Jakarta,-27,-7,-49,-36,-29,12,1180,18,1046,116,149018,2896,134407,11715,1.94%,90.20%,0.97,1,32,30,4,25,7,BAIK
11/12/2020,DKI Jakarta,-24,-4,-43,-37,-29,13,1232,4,1096,132,150250,2900,135503,11847,1.93%,90.19%,1.04,0.22,32,24,9,21,12,BAIK
12/12/2020,DKI Jakarta,-26,-3,-46,-28,-15,8,951,17,923,11,151201,2917,136426,11858,1.93%,90.23%,0.77,4.25,23,19,6,29,10,BAIK
13/12/2020,DKI Jakarta,-30,-9,-50,-27,-10,8,1298,16,1112,170,152499,2933,137538,12028,1.92%,90.19%,1.36,0.94,29,20,5,29,6,BAIK
14/12/2020,DKI Jakarta,-27,-7,-50,-37,-30,13,1506,17,1471,18,154005,2950,139009,12046,1.92%,90.26%,1.16,1.06,25,18,4,29,9,BAIK
15/12/2020,DKI Jakarta,-27,-6,-49,-36,-31,13,1116,22,1135,-41,155121,2972,140144,12005,1.92%,90.34%,0.74,1.29,26,18,6,24,8,BAIK
16/12/2020,DKI Jakarta,-26,-6,-48,-36,-30,12,1221,22,1142,57,156342,2994,141286,12062,1.92%,90.37%,1.09,1,21,17,5,19,7,BAIK
17/12/2020,DKI Jakarta,-26,-6,-46,-35,-30,12,1690,20,1371,299,158032,3014,142657,12361,1.91%,90.27%,1.38,0.91,24,21,5,30,7,BAIK
18/12/2020,DKI Jakarta,-23,-3,-37,-34,-29,13,1587,19,1234,334,159619,3033,143891,12695,1.90%,90.15%,0.94,0.95,25,19,5,25,8,BAIK
19/12/2020,DKI Jakarta,-27,-4,-45,-27,-14,8,1899,20,1097,782,161518,3053,144988,13477,1.89%,89.77%,1.2,1.05,27,19,6,24,9,BAIK
20/12/2020,DKI Jakarta,-31,-11,-54,-27,-11,8,1592,19,1874,-301,163110,3072,146862,13176,1.88%,90.04%,0.84,0.95,37,20,9,19,8,BAIK
21/12/2020,DKI Jakarta,-25,-5,-46,-35,-31,12,1466,15,1368,83,164576,3087,148230,13259,1.88%,90.07%,0.92,0.79,17,17,4,14,5,BAIK
22/12/2020,DKI Jakarta,-25,-5,-46,-35,-32,12,1311,14,1374,-77,165887,3101,149604,13182,1.87%,90.18%,0.89,0.93,23,19,6,16,10,BAIK
23/12/2020,DKI Jakarta,-23,-2,-46,-33,-32,11,1954,15,1444,495,167841,3116,151048,13677,1.86%,89.99%,1.49,1.07,43,26,7,26,13,SEDANG
24/12/2020,DKI Jakarta,-27,-7,-43,-42,-51,15,1933,16,1341,576,169774,3132,152389,14253,1.84%,89.76%,0.99,1.07,40,26,8,31,8,SEDANG
25/12/2020,DKI Jakarta,-34,-17,-42,-53,-66,22,2096,21,1727,348,171870,3153,154116,14601,1.83%,89.67%,1.08,1.31,23,23,4,25,5,BAIK
26/12/2020,DKI Jakarta,-36,-15,-49,-38,-26,10,2058,14,2551,-507,173928,3167,156667,14094,1.82%,90.08%,0.98,0.67,23,26,3,30,6,BAIK
27/12/2020,DKI Jakarta,-36,-17,-53,-33,-11,8,1997,22,1824,151,175925,3189,158491,14245,1.81%,90.09%,0.97,1.57,24,26,5,35,5,BAIK
28/12/2020,DKI Jakarta,-28,-6,-48,-40,-36,13,1678,21,1713,-56,177603,3210,160204,14189,1.81%,90.20%,0.84,0.95,26,27,4,33,8,BAIK
29/12/2020,DKI Jakarta,-29,-8,-49,-40,-38,14,2056,18,1002,1036,179659,3228,161206,15225,1.80%,89.73%,1.23,0.86,21,23,5,28,6,BAIK
30/12/2020,DKI Jakarta,-28,-4,-50,-38,-38,13,2053,21,1566,466,181712,3249,162772,15691,1.79%,89.58%,1,1.17,19,22,4,25,7,BAIK
31/12/2020,DKI Jakarta,-32,-2,-47,-44,-55,15,2022,21,1968,33,183734,3270,164740,15724,1.78%,89.66%,0.98,1,26,25,8,29,10,BAIK
1/1/2021,DKI Jakarta,-46,-27,-51,-61,-73,22,1956,20,1643,293,185690,3290,166383,16017,1.77%,89.60%,0.97,0.95,38,29,6,31,13,SEDANG
2/1/2021,DKI Jakarta,-39,-15,-50,-41,-33,11,1894,26,2280,-412,187584,3316,168663,15605,1.77%,89.91%,0.97,1.3,27,27,7,47,7,BAIK
3/1/2021,DKI Jakarta,-40,-19,-58,-34,-15,9,1658,10,1691,-43,189242,3326,170354,15562,1.76%,90.02%,0.88,0.38,44,25,7,40,13,SEDANG
4/1/2021,DKI Jakarta,-29,-5,-50,-39,-32,13,1832,21,2527,-716,191074,3347,172881,14846,1.75%,90.48%,1.1,2.1,30,24,4,32,7,BAIK
5/1/2021,DKI Jakarta,-32,-9,-53,-39,-33,14,1824,19,1339,466,192898,3366,174220,15312,1.74%,90.32%,1,0.9,38,24,6,31,9,SEDANG
6/1/2021,DKI Jakarta,-30,-11,-52,-40,-32,14,2402,17,1095,1290,195300,3383,175315,16602,1.73%,89.77%,1.32,0.89,41,23,13,46,13,SEDANG
7/1/2021,DKI Jakarta,-31,-10,-51,-41,-33,15,2398,21,1446,931,197698,3404,176761,17533,1.72%,89.41%,1,1.24,35,22,6,39,10,BAIK
8/1/2021,DKI Jakarta,-28,-9,-44,-41,-31,15,2959,24,2690,245,200657,3428,179451,17778,1.71%,89.43%,1.23,1.14,37,26,16,17,10,SEDANG
9/1/2021,DKI Jakarta,-38,-18,-58,-39,-20,11,2753,27,2118,608,203410,3455,181569,18386,1.70%,89.26%,0.93,1.13,47,16,27,22,12,SEDANG
10/1/2021,DKI Jakarta,-32,-9,-55,-34,-12,9,2711,31,2898,-218,206121,3486,184467,18168,1.69%,89.49%,0.98,1.15,23,16,11,33,8,BAIK
11/1/2021,DKI Jakarta,-32,-12,-50,-43,-34,15,2461,31,2510,-80,208582,3517,186977,18088,1.69%,89.64%,0.91,1,38,17,14,27,10,SEDANG
12/1/2021,DKI Jakarta,-36,-17,-54,-44,-36,15,2669,34,1657,978,211251,3551,188634,19066,1.68%,89.29%,1.08,1.1,29,20,12,26,15,BAIK
13/01/2021,DKI Jakarta,-36,-18,-53,-45,-36,14,3476,45,2952,479,214727,3596,191586,19545,1.67%,89.22%,1.3,1.32,34,17,13,20,9,BAIK
14/01/2021,DKI Jakarta,-38,-23,-53,-48,-40,12,3165,43,2075,1047,217892,3639,193661,20592,1.67%,88.88%,0.91,0.96,36,15,15,26,13,SEDANG
15/01/2021,DKI Jakarta,-36,-22,-48,-49,-40,13,2541,35,2490,16,220433,3674,196151,20608,1.67%,88.98%,0.8,0.81,42,14,15,32,12,SEDANG
16/01/2021,DKI Jakarta,-39,-21,-53,-44,-28,8,3536,32,1772,1732,223969,3706,197923,22340,1.65%,88.37%,1.39,0.91,52,15,17,25,14,SEDANG
17/01/2021,DKI Jakarta,-41,-24,-57,-43,-23,8,3395,33,3776,-414,227364,3739,201699,21926,1.64%,88.71%,0.96,1.03,52,17,15,26,14,SEDANG
18/01/2021,DKI Jakarta,-39,-24,-55,-48,-41,14,2361,36,2801,-476,229725,3775,204500,21450,1.64%,89.02%,0.7,1.09,40,16,11,26,12,SEDANG
19/01/2021,DKI Jakarta,-39,-23,-56,-49,-41,14,2563,40,2500,23,232288,3815,207000,21473,1.64%,89.11%,1.09,1.11,31,13,12,25,12,BAIK
20/01/2021,DKI Jakarta,-38,-23,-55,-49,-40,14,3786,33,3770,-17,236074,3848,210770,21456,1.63%,89.28%,1.48,0.83,35,12,12,22,13,BAIK
21/01/2021,DKI Jakarta,-39,-24,-54,-49,-40,14,3151,30,2570,551,239225,3878,213340,22007,1.62%,89.18%,0.83,0.91,43,13,14,28,15,SEDANG
22/01/2021,DKI Jakarta,-35,-20,-47,-48,-37,15,3791,41,2169,1581,243016,3919,215509,23588,1.61%,88.68%,1.2,1.37,49,14,14,28,15,SEDANG
23/01/2021,DKI Jakarta,-37,-17,-52,-41,-23,9,3285,31,3492,-238,246301,3950,219001,23350,1.60%,88.92%,0.87,0.76,72,14,43,44,20,TIDAK SEHAT
24/01/2021,DKI Jakarta,-48,-33,-71,-50,-26,13,3512,39,2328,1145,249813,3989,221329,24495,1.60%,88.60%,1.07,1.26,33,12,14,23,10,BAIK
25/01/2021,DKI Jakarta,-34,-16,-52,-45,-37,14,2451,43,2504,-96,252264,4032,223833,24399,1.60%,88.73%,0.7,1.1,56,13,29,62,15,SEDANG
26/01/2021,DKI Jakarta,-36,-18,-55,-45,-38,14,2313,46,2939,-672,254577,4078,226772,23727,1.60%,89.08%,0.94,1.07,52,14,19,28,13,SEDANG
27/01/2021,DKI Jakarta,-35,-18,-54,-46,-37,14,1836,34,2970,-1168,256413,4112,229742,22559,1.60%,89.60%,0.79,0.74,20,13,10,19,8,BAIK
28/01/2021,DKI Jakarta,-34,-15,-50,-45,-37,13,2889,40,2731,118,259302,4152,232473,22677,1.60%,89.65%,1.57,1.18,27,14,18,17,11,BAIK
29/01/2021,DKI Jakarta,-33,-14,-46,-45,-36,14,3448,44,2428,976,262750,4196,234901,23653,1.60%,89.40%,1.19,1.1,30,16,17,24,11,SEDANG
30/01/2021,DKI Jakarta,-36,-12,-56,-39,-23,8,3491,30,3565,-104,266241,4226,238466,23549,1.59%,89.57%,1.01,0.68,27,13,16,24,12,BAIK
31/01/2021,DKI Jakarta,-33,-8,-60,-35,-16,7,3474,42,3354,78,269715,4268,241820,23627,1.58%,89.66%,1,1.4,36,13,16,26,10,SEDANG
1/2/2021,DKI Jakarta,-33,-12,-54,-43,-36,12,3614,45,2352,1217,273329,4313,244172,24844,1.58%,89.33%,1.04,1.07,59,21,26,15,31,SEDANG
2/2/2021,DKI Jakarta,-32,-7,-52,-42,-37,12,3362,44,4577,-1259,276691,4357,248749,23585,1.57%,89.90%,0.93,0.98,30,21,14,16,24,BAIK
3/2/2021,DKI Jakarta,-34,-15,-57,-45,-37,13,3567,44,1391,2132,280258,4401,250140,25717,1.57%,89.25%,1.06,1,23,19,11,14,19,BAIK
4/2/2021,DKI Jakarta,-35,-17,-55,-45,-37,12,3632,40,3963,-371,283890,4441,254103,25346,1.56%,89.51%,1.02,0.91,36,23,14,12,24,SEDANG
5/2/2021,DKI Jakarta,-28,-6,-46,-42,-35,12,3340,45,2475,820,287230,4486,256578,26166,1.56%,89.33%,0.92,1.13,29,20,14,12,21,BAIK
6/2/2021,DKI Jakarta,-31,-6,-52,-35,-23,7,2379,44,4433,-2098,289609,4530,261011,24068,1.56%,90.13%,0.71,0.98,27,21,8,21,15,BAIK
7/2/2021,DKI Jakarta,-39,-20,-66,-41,-21,8,4212,45,4305,-138,293821,4575,265316,23930,1.56%,90.30%,1.77,1.02,25,19,7,19,12,BAIK
8/2/2021,DKI Jakarta,-33,-14,-55,-43,-37,12,3142,43,3415,-316,296963,4618,268731,23614,1.56%,90.49%,0.75,0.96,24,19,10,18,17,BAIK
9/2/2021,DKI Jakarta,-31,-9,-55,-42,-37,11,3437,57,2786,594,300400,4675,271517,24208,1.56%,90.39%,1.09,1.33,33,22,12,14,22,BAIK
10/2/2021,DKI Jakarta,-29,-8,-52,-41,-36,11,3308,43,3244,21,303708,4718,274761,24229,1.55%,90.47%,0.96,0.75,32,21,10,12,16,BAIK
11/2/2021,DKI Jakarta,-27,-6,-47,-37,-37,9,2513,51,4096,-1634,306221,4769,278857,22595,1.56%,91.06%,0.76,1.19,26,23,13,9,17,BAIK
12/2/2021,DKI Jakarta,-34,-17,-41,-55,-67,20,3807,50,5636,-1879,310028,4819,284493,20716,1.55%,91.76%,1.51,0.98,41,26,16,10,16,SEDANG
13/02/2021,DKI Jakarta,-35,-15,-48,-41,-30,8,3016,53,5010,-2047,313044,4872,289503,18669,1.56%,92.48%,0.79,1.06,25,20,9,19,16,BAIK
14/02/2021,DKI Jakarta,-37,-18,-57,-38,-19,7,2497,48,3977,-1528,315541,4920,293480,17141,1.56%,93.01%,0.83,0.91,33,18,11,19,19,BAIK
15/02/2021,DKI Jakarta,-32,-12,-51,-41,-35,11,1879,42,2081,-244,317420,4962,295561,16897,1.56%,93.11%,0.75,0.88,34,20,13,17,25,BAIK
16/02/2021,DKI Jakarta,-39,-21,-58,-44,-39,13,1861,62,1579,220,319281,5024,297140,17117,1.57%,93.07%,0.99,1.48,26,18,11,18,26,BAIK
17/02/2021,DKI Jakarta,-32,-12,-51,-42,-34,11,1446,31,2591,-1176,320727,5055,299731,15941,1.58%,93.45%,0.78,0.5,39,23,23,12,33,SEDANG
18/02/2021,DKI Jakarta,-39,-23,-57,-45,-36,13,373,35,2717,-2379,321100,5090,302448,13562,1.59%,94.19%,0.26,1.13,43,29,13,12,29,SEDANG
19/02/2021,DKI Jakarta,-30,-10,-46,-43,-34,13,1920,6,2757,-843,323020,5096,305205,12719,1.58%,94.48%,5.15,0.17,29,19,20,12,23,BAIK
20/02/2021,DKI Jakarta,-38,-14,-55,-40,-25,9,2872,40,2490,342,325892,5136,307695,13061,1.58%,94.42%,1.5,6.67,30,18,11,18,20,BAIK
21/02/2021,DKI Jakarta,-35,-12,-57,-38,-17,7,2725,55,2681,-11,328617,5191,310376,13050,1.58%,94.45%,0.95,1.38,31,18,10,16,17,BAIK
22/02/2021,DKI Jakarta,-31,-12,-50,-43,-34,11,2465,40,2305,120,331082,5231,312681,13170,1.58%,94.44%,0.9,0.73,51,20,18,11,23,SEDANG
23/02/2021,DKI Jakarta,-34,-15,-54,-43,-35,11,782,45,2052,-1315,331864,5276,314733,11855,1.59%,94.84%,0.32,1.13,50,22,11,20,23,SEDANG
24/02/2021,DKI Jakarta,-34,-18,-53,-44,-34,12,782,35,1857,-1110,332646,5311,316590,10745,1.60%,95.17%,1,0.78,30,22,10,9,16,BAIK
25/02/2021,DKI Jakarta,-29,-7,-49,-41,-33,10,1581,55,2656,-1130,334227,5366,319246,9615,1.61%,95.52%,2.02,1.57,31,26,12,14,17,BAIK
26/02/2021,DKI Jakarta,-24,-2,-41,-39,-32,11,1662,42,1864,-244,335889,5408,321110,9371,1.61%,95.60%,1.05,0.76,29,18,13,18,20,BAIK
27/02/2021,DKI Jakarta,-24,4,-42,-30,-19,5,1736,44,1163,529,337625,5452,322273,9900,1.61%,95.45%,1.04,1.05,49,23,15,17,31,SEDANG
28/02/2021,DKI Jakarta,-28,-3,-49,-31,-13,5,2098,43,891,1164,339723,5495,323164,11064,1.62%,95.13%,1.21,0.98,43,19,12,19,18,SEDANG
1/3/2021,DKI Jakarta,-29,-5,-51,-40,-33,10,2058,52,3132,-1126,341781,5547,326296,9938,1.62%,95.47%,0.98,1.21,37,20,12,12,17,SEDANG
2/3/2021,DKI Jakarta,-29,-5,-52,-40,-34,10,577,36,2165,-1624,342358,5583,328461,8314,1.63%,95.94%,0.28,0.69,38,20,15,14,28,SEDANG
3/3/2021,DKI Jakarta,-27,-5,-49,-39,-33,10,1437,38,2487,-1088,343795,5621,330948,7226,1.63%,96.26%,2.49,1.06,49,19,21,17,35,SEDANG
4/3/2021,DKI Jakarta,-29,-10,-50,-40,-33,10,2009,46,1750,213,345804,5667,332698,7439,1.64%,96.21%,1.4,1.21,51,22,18,19,31,SEDANG
5/3/2021,DKI Jakarta,-26,-6,-45,-39,-32,11,1160,45,1290,-175,346964,5712,333988,7264,1.65%,96.26%,0.58,0.98,52,20,16,16,30,SEDANG
6/3/2021,DKI Jakarta,-26,-2,-45,-29,-20,5,1615,44,1568,3,348579,5756,335556,7267,1.65%,96.26%,1.39,0.98,51,20,22,15,37,SEDANG
7/3/2021,DKI Jakarta,-31,-9,-52,-31,-16,6,1835,45,1764,26,350414,5801,337320,7293,1.66%,96.26%,1.14,1.02,57,23,23,19,31,SEDANG
8/3/2021,DKI Jakarta,-28,-7,-48,-39,-33,10,1783,48,1675,60,352197,5849,338995,7353,1.66%,96.25%,0.97,1.07,47,21,16,11,19,SEDANG
9/3/2021,DKI Jakarta,-29,-9,-49,-38,-34,10,867,45,1643,-821,353064,5894,340638,6532,1.67%,96.48%,0.49,0.94,36,23,15,10,22,BAIK
10/3/2021,DKI Jakarta,-25,-5,-46,-34,-32,9,1046,45,1477,-476,354110,5939,342115,6056,1.68%,96.61%,1.21,1,45,20,20,14,27,SEDANG
11/3/2021,DKI Jakarta,-28,-11,-41,-51,-66,18,1754,25,980,749,355864,5964,343095,6805,1.68%,96.41%,1.68,0.56,27,19,9,15,21,BAIK
12/3/2021,DKI Jakarta,-26,-6,-39,-40,-34,11,1872,50,1263,559,357736,6014,344358,7364,1.68%,96.26%,1.07,2,44,24,12,13,25,SEDANG
13/03/2021,DKI Jakarta,-28,-4,-40,-32,-20,6,1034,10,577,447,358770,6024,344935,7811,1.68%,96.14%,0.55,0.2,37,27,13,13,25,SEDANG
14/03/2021,DKI Jakarta,-31,-9,-44,-30,-16,5,1204,36,2367,-1199,359974,6060,347302,6612,1.68%,96.48%,1.16,3.6,39,23,14,10,19,SEDANG
15/03/2021,DKI Jakarta,-27,-6,-43,-37,-32,10,1555,35,1762,-242,361529,6095,349064,6370,1.69%,96.55%,1.29,0.97,45,29,18,13,34,SEDANG
16/03/2021,DKI Jakarta,-29,-9,-47,-38,-33,10,835,20,1491,-676,362364,6115,350555,5694,1.69%,96.74%,0.54,0.57,55,32,13,21,36,SEDANG
17/03/2021,DKI Jakarta,-28,-8,-43,-38,-31,10,1330,3,1183,144,363694,6118,351738,5838,1.68%,96.71%,1.59,0.15,59,25,19,20,45,SEDANG
18/03/2021,DKI Jakarta,-27,-8,-42,-38,-31,10,1719,20,1168,531,365413,6138,352906,6369,1.68%,96.58%,1.29,6.67,64,30,15,25,40,TIDAK SEHAT
19/03/2021,DKI Jakarta,-24,-5,-37,-36,-30,11,1588,24,1174,390,367001,6162,354080,6759,1.68%,96.48%,0.92,1.2,60,29,14,24,35,SEDANG
20/03/2021,DKI Jakarta,-27,-4,-42,-30,-17,6,1935,22,1184,729,368936,6184,355264,7488,1.68%,96.29%,1.22,0.92,55,28,16,19,31,SEDANG
21/03/2021,DKI Jakarta,-29,-7,-46,-31,-13,5,1638,23,1884,-269,370574,6207,357148,7219,1.67%,96.38%,0.85,1.05,43,21,11,18,17,SEDANG
22/03/2021,DKI Jakarta,-28,-7,-45,-38,-31,10,1474,8,1715,-249,372048,6215,358863,6970,1.67%,96.46%,0.9,0.35,38,21,13,14,18,SEDANG
23/03/2021,DKI Jakarta,-29,-8,-45,-38,-32,10,816,11,1691,-886,372864,6226,360554,6084,1.67%,96.70%,0.55,1.38,37,23,11,12,16,SEDANG
24/03/2021,DKI Jakarta,-28,-9,-42,-38,-31,10,890,11,1986,-1107,373754,6237,362540,4977,1.67%,97.00%,1.09,1,32,21,10,9,15,SEDANG
25/03/2021,DKI Jakarta,-25,-4,-41,-37,-31,10,1727,12,490,1225,375481,6249,363030,6202,1.66%,96.68%,1.94,1.09,25,22,9,14,17,BAIK
26/03/2021,DKI Jakarta,-21,0,-34,-35,-29,10,1381,11,897,473,376862,6260,363927,6675,1.66%,96.57%,0.8,0.92,50,23,19,19,28,SEDANG
27/03/2021,DKI Jakarta,-27,-5,-43,-29,-18,5,1354,18,599,737,378216,6278,364526,7412,1.66%,96.38%,0.98,1.64,53,29,13,18,33,SEDANG
28/03/2021,DKI Jakarta,-26,-3,-44,-28,-12,5,1470,23,1175,272,379686,6301,365701,7684,1.66%,96.32%,1.09,1.28,54,20,15,31,31,SEDANG
29/03/2021,DKI Jakarta,-25,-2,-42,-36,-31,9,1014,22,1079,-87,380700,6323,366780,7597,1.66%,96.34%,0.69,0.96,55,19,19,21,37,SEDANG
30/03/2021,DKI Jakarta,-26,-5,-45,-36,-32,9,384,21,1087,-724,381084,6344,367867,6873,1.66%,96.53%,0.38,0.95,53,24,15,14,30,SEDANG
31/03/2021,DKI Jakarta,-25,-4,-43,-32,-31,9,965,0,1073,-108,382049,6344,368940,6765,1.66%,96.57%,2.51,0,43,22,13,15,23,SEDANG
1/4/2021,DKI Jakarta,-19,9,-34,-27,-30,7,1337,18,988,331,383386,6362,369928,7096,1.66%,96.49%,1.39,,26,22,11,13,19,BAIK
2/4/2021,DKI Jakarta,-20,3,-24,-44,-63,15,1240,7,1292,-59,384626,6369,371220,7037,1.66%,96.51%,0.93,0.39,41,27,11,17,19,SEDANG
3/4/2021,DKI Jakarta,-27,-3,-41,-31,-24,5,1098,4,600,494,385724,6373,371820,7531,1.65%,96.40%,0.89,0.57,25,20,8,18,22,BAIK
4/4/2021,DKI Jakarta,-25,-1,-42,-22,-13,2,736,6,1599,-869,386460,6379,373419,6662,1.65%,96.63%,0.67,1.5,57,21,23,14,33,SEDANG
5/4/2021,DKI Jakarta,-22,3,-40,-32,-30,8,523,4,1187,-668,386983,6383,374606,5994,1.65%,96.80%,0.71,0.67,52,22,15,18,27,SEDANG
6/4/2021,DKI Jakarta,-23,1,-42,-32,-31,8,487,4,587,-104,387470,6387,375193,5890,1.65%,96.83%,0.93,1,33,27,10,14,18,SEDANG
7/4/2021,DKI Jakarta,-23,-2,-43,-32,-31,9,862,9,695,158,388332,6396,375888,6048,1.65%,96.80%,1.77,2.25,30,25,11,13,19,BAIK
8/4/2021,DKI Jakarta,-21,1,-37,-31,-30,8,1238,4,485,749,389570,6400,376373,6797,1.64%,96.61%,1.44,0.44,38,33,12,13,22,SEDANG
9/4/2021,DKI Jakarta,-16,3,-32,-31,-28,8,1013,10,623,380,390583,6410,376996,7177,1.64%,96.52%,0.82,2.5,54,26,14,15,28,SEDANG
10/4/2021,DKI Jakarta,-19,6,-33,-20,-16,3,977,7,856,114,391560,6417,377852,7291,1.64%,96.50%,0.96,0.7,48,23,13,17,29,SEDANG
11/4/2021,DKI Jakarta,-21,4,-41,-18,-11,2,1031,7,1396,-372,392591,6424,379248,6919,1.64%,96.60%,1.06,1,45,31,12,25,31,SEDANG
12/4/2021,DKI Jakarta,-21,3,-39,-29,-31,8,692,7,1357,-672,393283,6431,380605,6247,1.64%,96.78%,0.67,1,55,26,20,15,31,SEDANG
13/04/2021,DKI Jakarta,-38,-11,-56,-44,-37,15,828,6,900,-78,394111,6437,381505,6169,1.63%,96.80%,1.2,0.86,55,23,18,21,40,SEDANG
14/04/2021,DKI Jakarta,-35,-15,-54,-41,-33,13,661,7,614,40,394772,6444,382119,6209,1.63%,96.79%,0.8,1.17,51,27,15,25,32,SEDANG
15/04/2021,DKI Jakarta,-34,-14,-51,-40,-32,13,1330,6,690,634,396102,6450,382809,6843,1.63%,96.64%,2.01,0.86,56,24,24,21,40,SEDANG
16/04/2021,DKI Jakarta,-26,-3,-40,-38,-29,13,980,18,871,91,397082,6468,383680,6934,1.63%,96.62%,0.74,3,55,24,20,16,42,SEDANG
17/04/2021,DKI Jakarta,-31,-7,-50,-35,-17,9,1037,18,999,20,398119,6486,384679,6954,1.63%,96.62%,1.06,1,65,24,19,19,41,TIDAK SEHAT
18/04/2021,DKI Jakarta,-31,-8,-58,-35,-11,9,950,13,987,-50,399069,6499,385666,6904,1.63%,96.64%,0.92,0.72,57,24,11,25,26,SEDANG
19/04/2021,DKI Jakarta,-28,-7,-46,-37,-29,12,973,14,971,-12,400042,6513,386637,6892,1.63%,96.65%,1.02,1.08,63,25,14,26,30,SEDANG
20/04/2021,DKI Jakarta,-28,-5,-46,-37,-30,12,460,14,897,-451,400502,6527,387534,6441,1.63%,96.76%,0.47,1,56,25,12,21,30,SEDANG
21/04/2021,DKI Jakarta,-26,-6,-46,-37,-30,12,602,12,573,17,401104,6539,388107,6458,1.63%,96.76%,1.31,0.86,63,24,19,14,37,SEDANG
22/04/2021,DKI Jakarta,-26,-7,-44,-38,-29,11,1266,11,652,603,402370,6550,388759,7061,1.63%,96.62%,2.1,0.92,54,25,14,23,40,SEDANG
23/04/2021,DKI Jakarta,-23,-4,-39,-36,-28,12,884,18,721,145,403254,6568,389480,7206,1.63%,96.58%,0.7,1.64,66,25,16,21,42,SEDANG
24/04/2021,DKI Jakarta,-24,0,-44,-29,-14,7,907,12,886,9,404161,6580,390366,7215,1.63%,96.59%,1.03,0.67,66,23,18,30,40,SEDANG
25/04/2021,DKI Jakarta,-25,-3,-56,-29,-8,8,896,14,962,-80,405057,6594,391328,7135,1.63%,96.61%,0.99,1.17,63,24,15,17,36,SEDANG
26/04/2021,DKI Jakarta,-23,-2,-41,-35,-28,11,748,14,1339,-605,405805,6608,392667,6530,1.63%,96.76%,0.83,1,56,26,10,22,24,SEDANG
27/04/2021,DKI Jakarta,-25,-3,-46,-36,-29,11,394,17,600,-223,406199,6625,393267,6307,1.63%,96.82%,0.53,1.21,62,26,12,23,28,SEDANG
28/04/2021,DKI Jakarta,-25,-6,-48,-35,-30,11,639,14,682,-57,406838,6639,393949,6250,1.63%,96.83%,1.62,0.82,54,21,15,21,34,SEDANG
29/04/2021,DKI Jakarta,-20,3,-42,-33,-29,10,987,23,480,484,407825,6662,394429,6734,1.63%,96.72%,1.54,1.64,57,23,17,18,38,SEDANG
30/04/2021,DKI Jakarta,-13,13,-33,-29,-26,10,789,4,539,246,408614,6666,394968,6980,1.63%,96.66%,0.8,0.17,61,23,18,20,42,SEDANG
1/5/2021,DKI Jakarta,-15,14,-39,-22,-33,7,926,15,793,118,409540,6681,395761,7098,1.63%,96.64%,1.17,3.75,52,23,10,20,33,SEDANG
2/5/2021,DKI Jakarta,-16,11,-53,-20,-8,5,854,10,984,-140,410394,6691,396745,6958,1.63%,96.67%,0.92,0.67,50,22,9,18,17,SEDANG
3/5/2021,DKI Jakarta,-15,13,-39,-29,-29,8,757,20,687,50,411151,6711,397432,7008,1.63%,96.66%,0.89,2,53,26,10,20,20,SEDANG
4/5/2021,DKI Jakarta,-17,10,-41,-28,-31,9,416,18,586,-188,411567,6729,398018,6820,1.63%,96.71%,0.55,0.9,59,31,14,14,26,SEDANG
5/5/2021,DKI Jakarta,-19,5,-43,-30,-32,9,845,12,687,146,412412,6741,398705,6966,1.63%,96.68%,2.03,0.67,58,22,18,14,38,SEDANG
6/5/2021,DKI Jakarta,-20,4,-43,-36,-32,10,906,21,566,319,413318,6762,399271,7285,1.64%,96.60%,1.07,1.75,49,19,16,18,38,SEDANG
7/5/2021,DKI Jakarta,-13,12,-36,-36,-30,10,783,20,595,168,414101,6782,399866,7453,1.64%,96.56%,0.86,0.95,54,20,26,19,45,SEDANG
8/5/2021,DKI Jakarta,-17,12,-46,-29,-20,6,732,26,584,122,414833,6808,400450,7575,1.64%,96.53%,0.93,1.3,52,20,12,19,28,SEDANG
9/5/2021,DKI Jakarta,-16,11,-56,-28,-10,7,809,16,690,103,415642,6824,401140,7678,1.64%,96.51%,1.11,0.62,41,18,9,26,21,SEDANG
10/5/2021,DKI Jakarta,-12,17,-37,-36,-38,10,694,22,607,65,416336,6846,401747,7743,1.64%,96.50%,0.86,1.38,47,19,10,25,21,SEDANG
11/5/2021,DKI Jakarta,-14,20,-38,-35,-43,10,406,20,667,-281,416742,6866,402414,7462,1.65%,96.56%,0.59,0.91,60,24,12,25,24,SEDANG
12/5/2021,DKI Jakarta,-21,19,-35,-46,-67,17,656,13,674,-31,417398,6879,403088,7431,1.65%,96.57%,1.62,0.65,59,21,10,25,21,SEDANG
13/05/2021,DKI Jakarta,-34,-13,-28,-56,-75,12,785,15,585,185,418183,6894,403673,7616,1.65%,96.53%,1.2,1.15,70,24,14,24,20,TIDAK SEHAT
14/05/2021,DKI Jakarta,-28,-8,-25,-54,-76,16,632,16,547,69,418815,6910,404220,7685,1.65%,96.52%,0.81,1.07,52,24,8,25,14,SEDANG
15/05/2021,DKI Jakarta,-27,-5,-40,-37,-49,6,227,15,573,-361,419042,6925,404793,7324,1.65%,96.60%,0.36,0.94,51,26,11,20,19,SEDANG
16/05/2021,DKI Jakarta,-26,-4,-53,-33,-20,4,161,18,592,-449,419203,6943,405385,6875,1.66%,96.70%,0.71,1.2,51,23,8,20,16,SEDANG
17/05/2021,DKI Jakarta,-21,3,-45,-40,-40,10,421,25,0,396,419624,6968,405385,7271,1.66%,96.61%,2.61,1.39,47,22,11,24,24,SEDANG
18/05/2021,DKI Jakarta,-22,1,-44,-34,-39,10,219,15,194,10,419843,6983,405579,7281,1.66%,96.60%,0.52,0.6,40,24,10,23,26,SEDANG
19/05/2021,DKI Jakarta,-21,2,-43,-33,-35,9,611,19,197,395,420454,7002,405776,7676,1.67%,96.51%,2.79,1.27,52,23,17,19,36,SEDANG
20/05/2021,DKI Jakarta,-21,3,-40,-37,-32,9,895,20,96,779,421349,7022,405872,8455,1.67%,96.33%,1.46,1.05,57,24,12,23,27,SEDANG
21/05/2021,DKI Jakarta,-20,0,-39,-35,-30,11,856,16,100,740,422205,7038,405972,9195,1.67%,96.16%,0.96,0.8,52,24,15,22,34,SEDANG
22/05/2021,DKI Jakarta,-23,2,-45,-27,-19,6,932,12,397,523,423137,7050,406369,9718,1.67%,96.04%,1.09,0.75,56,22,16,28,36,SEDANG
23/05/2021,DKI Jakarta,-24,0,-50,-26,-10,6,867,12,340,515,424004,7062,406709,10233,1.67%,95.92%,0.93,1,60,24,21,27,37,SEDANG
24/05/2021,DKI Jakarta,-23,-2,-45,-33,-29,10,819,10,302,507,424823,7072,407011,10740,1.66%,95.81%,0.94,0.83,74,22,20,23,38,TIDAK SEHAT
25/05/2021,DKI Jakarta,-17,9,-41,-29,-30,8,384,14,506,-136,425207,7086,407517,10604,1.67%,95.84%,0.47,1.4,44,23,15,23,35,SEDANG
26/05/2021,DKI Jakarta,-16,4,-31,-42,-65,16,617,11,516,90,425824,7097,408033,10694,1.67%,95.82%,1.61,0.79,56,27,11,21,24,SEDANG
27/05/2021,DKI Jakarta,-19,4,-39,-32,-29,9,940,18,586,336,426764,7115,408619,11030,1.67%,95.75%,1.52,1.64,51,27,8,16,20,SEDANG
28/05/2021,DKI Jakarta,-14,10,-33,-31,-27,10,602,19,908,-325,427366,7134,409527,10705,1.67%,95.83%,0.64,1.06,54,29,12,16,24,SEDANG
29/05/2021,DKI Jakarta,-24,0,-48,-28,-17,6,898,12,998,-112,428264,7146,410525,10593,1.67%,95.86%,1.49,0.63,56,23,14,17,32,SEDANG
30/05/2021,DKI Jakarta,-19,6,-46,-24,-10,4,1064,13,1004,47,429328,7159,411529,10640,1.67%,95.85%,1.18,1.08,47,24,16,18,29,SEDANG
31/05/2021,DKI Jakarta,-14,10,-35,-29,-30,9,726,19,581,126,430054,7178,412110,10766,1.67%,95.83%,0.68,1.46,55,21,15,19,33,SEDANG
1/6/2021,DKI Jakarta,-15,7,-30,-41,-67,17,519,11,509,-1,430573,7189,412619,10765,1.67%,95.83%,0.71,0.58,59,22,18,19,35,SEDANG
2/6/2021,DKI Jakarta,-17,8,-40,-28,-29,9,602,20,587,-5,431175,7209,413206,10760,1.67%,95.83%,1.16,1.82,59,21,20,24,38,SEDANG
3/6/2021,DKI Jakarta,-15,10,-38,-30,-28,9,715,21,501,193,431890,7230,413707,10953,1.67%,95.79%,1.19,1.05,54,22,20,17,41,SEDANG
4/6/2021,DKI Jakarta,-13,10,-34,-30,-26,10,906,20,814,72,432796,7250,414521,11025,1.68%,95.78%,1.27,0.95,63,20,13,14,30,SEDANG
5/6/2021,DKI Jakarta,-15,13,-36,-21,-16,5,1317,22,828,467,434113,7272,415349,11492,1.68%,95.68%,1.45,1.1,59,23,20,19,38,SEDANG
6/6/2021,DKI Jakarta,-19,5,-45,-22,-11,5,1019,20,884,115,435132,7292,416233,11607,1.68%,95.66%,0.77,0.91,59,22,15,19,32,SEDANG
7/6/2021,DKI Jakarta,-15,10,-38,-30,-28,9,1197,20,874,303,436329,7312,417107,11910,1.68%,95.59%,1.17,1,52,24,13,28,31,SEDANG
8/6/2021,DKI Jakarta,-18,6,-41,-31,-29,10,755,20,948,-213,437084,7332,418055,11697,1.68%,95.65%,0.63,1,58,26,16,24,38,SEDANG
9/6/2021,DKI Jakarta,-16,6,-39,-30,-29,10,1376,14,1112,250,438460,7346,419167,11947,1.68%,95.60%,1.82,0.7,58,24,14,23,34,SEDANG
10/6/2021,DKI Jakarta,-16,7,-37,-30,-28,10,2091,25,1105,961,440551,7371,420272,12908,1.67%,95.40%,1.52,1.79,66,23,23,18,47,SEDANG
11/6/2021,DKI Jakarta,-14,7,-33,-30,-27,11,2293,21,1182,1090,442844,7392,421454,13998,1.67%,95.17%,1.1,0.84,59,22,15,23,40,SEDANG
12/6/2021,DKI Jakarta,-16,11,-36,-22,-15,5,2455,19,746,1690,445299,7411,422200,15688,1.66%,94.81%,1.07,0.9,57,24,17,27,35,SEDANG
13/06/2021,DKI Jakarta,-19,5,-42,-23,-11,6,2769,19,935,1815,448068,7430,423135,17503,1.66%,94.44%,1.13,1,51,23,14,25,25,SEDANG
14/06/2021,DKI Jakarta,-17,7,-36,-30,-29,10,2722,39,1034,1649,450790,7469,424169,19152,1.66%,94.09%,0.98,2.05,58,25,13,22,26,SEDANG
15/06/2021,DKI Jakarta,-22,1,-43,-32,-30,11,1502,20,1194,288,452292,7489,425363,19440,1.66%,94.05%,0.55,0.51,62,31,13,17,29,SEDANG
16/06/2021,DKI Jakarta,-20,3,-42,-32,-31,11,2376,34,1276,1066,454668,7523,426639,20506,1.65%,93.84%,1.58,1.7,56,39,18,13,35,SEDANG
17/06/2021,DKI Jakarta,-21,1,-42,-35,-31,11,4144,50,1877,2217,458812,7573,428516,22723,1.65%,93.40%,1.74,1.47,56,28,25,17,39,SEDANG
18/06/2021,DKI Jakarta,-21,1,-40,-36,-30,13,4737,66,2110,2561,463549,7639,430626,25284,1.65%,92.90%,1.14,1.32,64,29,17,16,34,SEDANG
19/06/2021,DKI Jakarta,-27,2,-49,-32,-19,9,4894,60,2441,2393,468443,7699,433067,27677,1.64%,92.45%,1.03,0.91,54,26,21,13,45,SEDANG
20/06/2021,DKI Jakarta,-32,-7,-56,-35,-15,10,5582,69,2457,3056,474025,7768,435524,30733,1.64%,91.88%,1.14,1.15,75,33,25,21,44,TIDAK SEHAT
21/06/2021,DKI Jakarta,-25,2,-46,-38,-34,13,5014,74,2835,2105,479039,7842,438359,32838,1.64%,91.51%,0.9,1.07,52,24,16,18,31,SEDANG
22/06/2021,DKI Jakarta,-26,3,-46,-40,-36,13,3220,59,3481,-320,482259,7901,441840,32518,1.64%,91.62%,0.64,0.8,44,27,15,16,32,SEDANG
23/06/2021,DKI Jakarta,-28,0,-47,-42,-36,14,4693,47,1190,3456,486952,7948,443030,35974,1.63%,90.98%,1.46,0.8,54,26,17,24,43,SEDANG
24/06/2021,DKI Jakarta,-28,0,-48,-43,-37,15,7505,49,2438,5018,494457,7997,445468,40992,1.62%,90.09%,1.6,1.04,65,31,17,17,39,SEDANG
25/06/2021,DKI Jakarta,-25,7,-45,-44,-37,16,6934,69,2571,4294,501391,8066,448039,45286,1.61%,89.36%,0.92,1.41,59,36,14,17,32,SEDANG
26/06/2021,DKI Jakarta,-32,5,-55,-39,-23,11,9271,51,2724,6496,510662,8117,450763,51782,1.59%,88.27%,1.34,0.74,54,31,10,21,23,SEDANG
27/06/2021,DKI Jakarta,-38,-5,-64,-42,-19,12,9393,51,3505,5837,520055,8168,454268,57619,1.57%,87.35%,1.01,1,65,27,18,22,32,SEDANG
28/06/2021,DKI Jakarta,-27,8,-49,-44,-40,16,8348,80,3414,4854,528403,8248,457682,62473,1.56%,86.62%,0.89,1.57,55,24,18,26,38,SEDANG
29/06/2021,DKI Jakarta,-32,2,-54,-47,-43,16,7379,80,3505,3794,535782,8328,461187,66267,1.55%,86.08%,0.88,1,66,30,15,20,28,SEDANG
30/06/2021,DKI Jakarta,-31,4,-54,-48,-43,15,7680,71,3522,4087,543462,8399,464709,70354,1.55%,85.51%,1.04,0.89,65,26,19,19,38,SEDANG
1/7/2021,DKI Jakarta,-30,8,-51,-47,-43,17,7541,46,3527,3968,551003,8445,468236,74322,1.53%,84.98%,0.98,0.65,55,27,14,20,31,SEDANG
2/7/2021,DKI Jakarta,-26,12,-47,-47,-41,18,9399,70,5013,4316,560402,8515,473249,78638,1.52%,84.45%,1.25,1.52,55,33,16,14,30,SEDANG
3/7/2021,DKI Jakarta,-45,0,-63,-50,-34,16,9701,16,5681,4004,570103,8531,478930,82642,1.50%,84.01%,1.03,0.23,58,33,12,19,25,SEDANG
4/7/2021,DKI Jakarta,-49,-7,-70,-52,-29,16,10485,66,5816,4603,580588,8597,484746,87245,1.48%,83.49%,1.08,4.13,68,27,11,27,22,TIDAK SEHAT
5/7/2021,DKI Jakarta,-40,0,-56,-54,-50,20,10902,120,6596,4186,591490,8717,491342,91431,1.47%,83.07%,1.04,1.82,71,28,12,34,25,TIDAK SEHAT
6/7/2021,DKI Jakarta,-43,-4,-58,-55,-51,21,9439,137,6100,3202,600929,8854,497442,94633,1.47%,82.78%,0.87,1.14,56,26,9,29,29,SEDANG
7/7/2021,DKI Jakarta,-43,-5,-58,-56,-51,21,9365,142,3655,5568,610294,8996,501097,100201,1.47%,82.11%,0.99,1.04,64,34,10,22,27,SEDANG
8/7/2021,DKI Jakarta,-43,-6,-56,-57,-51,21,12974,136,10854,1984,623268,9132,511951,102185,1.47%,82.14%,1.39,0.96,68,32,10,26,26,SEDANG
9/7/2021,DKI Jakarta,-43,-5,-54,-58,-50,23,13111,138,15029,-2056,636379,9270,526980,100129,1.46%,82.81%,1.01,1.01,70,33,9,28,25,TIDAK SEHAT
10/7/2021,DKI Jakarta,-49,-7,-65,-54,-36,17,12920,87,16839,-4006,649299,9357,543819,96123,1.44%,83.75%,0.99,0.63,64,35,7,24,23,SEDANG
11/7/2021,DKI Jakarta,-51,-14,-72,-55,-29,17,13133,46,20602,-7515,662432,9403,564421,88608,1.42%,85.20%,1.02,0.53,54,32,6,21,15,SEDANG
12/7/2021,DKI Jakarta,-43,-8,-56,-60,-51,21,14622,134,20477,-5989,677054,9537,584898,82619,1.41%,86.39%,1.11,2.91,46,29,5,18,13,SEDANG
13/07/2021,DKI Jakarta,-46,-12,-59,-60,-53,22,12183,68,4571,7544,689237,9605,589469,90163,1.39%,85.52%,0.83,0.51,63,33,10,18,24,SEDANG
14/07/2021,DKI Jakarta,-45,-12,-59,-60,-51,22,12669,63,3069,9537,701906,9668,592538,99700,1.38%,84.42%,1.04,0.93,53,28,10,17,23,SEDANG
15/07/2021,DKI Jakarta,-44,-10,-57,-60,-51,21,12691,141,3034,9516,714597,9809,595572,109216,1.37%,83.34%,1,2.24,66,31,12,24,30,SEDANG
16/07/2021,DKI Jakarta,-43,-9,-55,-60,-49,23,12416,132,8448,3836,727013,9941,604020,113052,1.37%,83.08%,0.98,0.94,71,30,11,24,29,SEDANG
17/07/2021,DKI Jakarta,-48,-8,-64,-55,-34,16,10168,67,11610,-1509,737181,10008,615630,111543,1.36%,83.51%,0.82,0.51,63,29,8,28,20,SEDANG
18/07/2021,DKI Jakarta,-50,-14,-71,-57,-26,16,9129,158,11852,-2881,746310,10166,627482,108662,1.36%,84.08%,0.9,2.36,63,31,8,32,19,SEDANG
19/07/2021,DKI Jakarta,-40,-2,-53,-57,-52,20,5000,250,12659,-7909,751310,10416,640141,100753,1.39%,85.20%,0.55,1.58,66,26,10,32,28,SEDANG
20/07/2021,DKI Jakarta,-55,-24,-65,-72,-79,28,6213,268,12066,-6121,757523,10684,652207,94632,1.41%,86.10%,1.24,1.07,74,27,15,24,24,SEDANG
21/07/2021,DKI Jakarta,-44,-9,-59,-58,-49,19,5904,95,10545,-4736,763427,10779,662752,89896,1.41%,86.81%,0.95,0.35,48,27,7,26,17,SEDANG
22/07/2021,DKI Jakarta,-43,-10,-56,-59,-48,19,7060,195,10631,-3766,770487,10974,673383,86130,1.42%,87.40%,1.2,2.05,53,31,9,24,26,SEDANG
23/07/2021,DKI Jakarta,-43,-10,-56,-59,-47,22,8033,157,14510,-6634,778520,11131,687893,79496,1.43%,88.36%,1.14,0.81,58,26,9,27,28,SEDANG
24/07/2021,DKI Jakarta,-47,-9,-63,-54,-32,15,8359,151,14528,-6320,786879,11282,702421,73176,1.43%,89.27%,1.04,0.96,53,26,13,21,34,SEDANG
25/07/2021,DKI Jakarta,-46,-9,-69,-54,-23,14,5394,157,14224,-8987,792273,11439,716645,64189,1.44%,90.45%,0.65,1.04,70,25,23,28,38,TIDAK SEHAT
26/07/2021,DKI Jakarta,-38,-5,-54,-55,-44,18,2662,160,14652,-12150,794935,11599,731297,52039,1.46%,91.99%,0.49,1.02,65,27,14,17,32,SEDANG
27/07/2021,DKI Jakarta,-40,-7,-56,-56,-46,19,3567,184,14849,-11466,798502,11783,746146,40573,1.48%,93.44%,1.34,1.15,61,29,10,23,28,SEDANG
28/07/2021,DKI Jakarta,-38,-6,-55,-55,-44,18,5525,69,10936,-5480,804027,11852,757082,35093,1.47%,94.16%,1.55,0.38,68,31,13,20,30,TIDAK SEHAT
29/07/2021,DKI Jakarta,-37,-5,-53,-55,-43,18,3845,27,11422,-7604,807872,11879,768504,27489,1.47%,95.13%,0.7,0.39,59,28,13,24,32,SEDANG
30/07/2021,DKI Jakarta,-35,0,-49,-54,-42,19,3454,43,11146,-7735,811326,11922,779650,19754,1.47%,96.10%,0.9,1.59,73,29,12,39,35,TIDAK SEHAT
31/07/2021,DKI Jakarta,-39,1,-59,-49,-26,12,3328,251,4961,-1884,814654,12173,784611,17870,1.49%,96.31%,0.96,5.84,54,26,7,27,24,SEDANG
1/8/2021,DKI Jakarta,-42,-5,-67,-51,-22,12,2701,71,4595,-1965,817355,12244,789206,15905,1.50%,96.56%,0.81,0.28,51,25,8,29,22,SEDANG
2/8/2021,DKI Jakarta,-32,2,-51,-51,-41,16,1410,154,2161,-905,818765,12398,791367,15000,1.51%,96.65%,0.52,2.17,47,24,10,25,28,SEDANG
3/8/2021,DKI Jakarta,-34,-1,-53,-51,-42,16,1601,70,2506,-975,820366,12468,793873,14025,1.52%,96.77%,1.14,0.45,50,26,11,19,35,SEDANG
4/8/2021,DKI Jakarta,-34,-2,-52,-51,-41,16,2981,63,2470,448,823347,12531,796343,14473,1.52%,96.72%,1.86,0.9,52,29,8,24,26,SEDANG
5/8/2021,DKI Jakarta,-37,-6,-55,-51,-41,17,2312,126,2759,-573,825659,12657,799102,13900,1.53%,96.78%,0.78,2,52,29,9,21,27,SEDANG
6/8/2021,DKI Jakarta,-31,2,-45,-51,-39,17,2185,53,3206,-1074,827844,12710,802308,12826,1.54%,96.92%,0.95,0.42,56,28,15,11,28,SEDANG
7/8/2021,DKI Jakarta,-36,2,-56,-46,-25,11,2008,68,4556,-2616,829852,12778,806864,10210,1.54%,97.23%,0.92,1.28,55,31,7,18,18,SEDANG
8/8/2021,DKI Jakarta,-39,-5,-63,-49,-19,10,1649,20,1199,430,831501,12798,808063,10640,1.54%,97.18%,0.82,0.29,53,33,6,23,16,SEDANG
9/8/2021,DKI Jakarta,-32,-2,-50,-50,-40,15,727,14,1009,-296,832228,12812,809072,10344,1.54%,97.22%,0.44,0.7,52,30,6,25,15,SEDANG
10/8/2021,DKI Jakarta,-35,-6,-55,-51,-42,16,1426,39,1174,213,833654,12851,810246,10557,1.54%,97.19%,1.96,2.79,32,25,7,29,16,BAIK
11/8/2021,DKI Jakarta,-34,-5,-51,-60,-67,22,1957,42,1334,581,835611,12893,811580,11138,1.54%,97.12%,1.37,1.08,55,25,10,24,25,SEDANG
12/8/2021,DKI Jakarta,-30,-3,-50,-48,-37,14,1080,42,2471,-1433,836691,12935,814051,9705,1.55%,97.29%,0.55,1,55,28,8,20,19,SEDANG
13/08/2021,DKI Jakarta,-29,-1,-45,-48,-36,16,1210,68,1568,-426,837901,13003,815619,9279,1.55%,97.34%,1.12,1.62,56,28,10,17,28,SEDANG
14/08/2021,DKI Jakarta,-33,0,-54,-43,-20,10,1363,29,1213,121,839264,13032,816832,9400,1.55%,97.33%,1.13,0.43,65,30,15,24,36,SEDANG
15/08/2021,DKI Jakarta,-36,-6,-60,-46,-16,10,1182,17,1066,99,840446,13049,817898,9499,1.55%,97.32%,0.87,0.59,56,31,8,17,20,SEDANG
16/08/2021,DKI Jakarta,-27,0,-47,-47,-39,14,513,28,944,-459,840959,13077,818842,9040,1.56%,97.37%,0.43,1.65,53,30,8,17,19,SEDANG
17/08/2021,DKI Jakarta,-37,-13,-48,-61,-73,22,654,24,917,-287,841613,13101,819759,8753,1.56%,97.40%,1.27,0.86,56,28,13,26,22,SEDANG
18/08/2021,DKI Jakarta,-32,-6,-51,-47,-36,14,1029,13,892,124,842642,13114,820651,8877,1.56%,97.39%,1.57,0.54,59,25,11,27,26,SEDANG
19/08/2021,DKI Jakarta,-31,-6,-49,-49,-36,14,731,34,949,-252,843373,13148,821600,8625,1.56%,97.42%,0.71,2.62,60,31,15,24,35,SEDANG
20/08/2021,DKI Jakarta,-28,-2,-44,-48,-34,15,968,11,944,13,844341,13159,822544,8638,1.56%,97.42%,1.32,0.32,58,29,11,32,34,SEDANG
21/08/2021,DKI Jakarta,-31,-1,-52,-43,-19,10,891,13,912,-34,845232,13172,823456,8604,1.56%,97.42%,0.92,1.18,59,25,13,26,35,SEDANG
22/08/2021,DKI Jakarta,-34,-7,-57,-45,-14,9,702,28,899,-225,845934,13200,824355,8379,1.56%,97.45%,0.79,2.15,59,28,14,25,28,SEDANG
23/08/2021,DKI Jakarta,-28,-4,-47,-47,-35,14,485,20,640,-175,846419,13220,824995,8204,1.56%,97.47%,0.69,0.71,56,28,10,25,27,SEDANG
24/08/2021,DKI Jakarta,-30,-6,-50,-47,-37,14,484,10,526,-52,846903,13230,825521,8152,1.56%,97.48%,1,0.5,59,27,12,32,30,SEDANG
25/08/2021,DKI Jakarta,-26,0,-48,-45,-35,13,789,9,723,57,847692,13239,826244,8209,1.56%,97.47%,1.63,0.9,62,26,12,34,34,SEDANG
26/08/2021,DKI Jakarta,-25,0,-45,-45,-35,13,574,10,1029,-465,848266,13249,827273,7744,1.56%,97.53%,0.73,1.11,56,27,10,22,33,SEDANG
27/08/2021,DKI Jakarta,-22,3,-41,-45,-33,14,635,9,353,273,848901,13258,827626,8017,1.56%,97.49%,1.11,0.9,62,30,11,25,31,SEDANG
28/08/2021,DKI Jakarta,-25,6,-46,-39,-18,7,468,10,453,5,849369,13268,828079,8022,1.56%,97.49%,0.74,1.11,65,26,11,40,27,SEDANG
29/08/2021,DKI Jakarta,-29,-2,-54,-42,-14,7,474,6,703,-235,849843,13274,828782,7787,1.56%,97.52%,1.01,0.6,65,28,12,30,29,SEDANG
30/08/2021,DKI Jakarta,-23,2,-45,-43,-34,12,341,5,880,-544,850184,13279,829662,7243,1.56%,97.59%,0.72,0.83,79,27,17,39,41,TIDAK SEHAT
31/08/2021,DKI Jakarta,-24,5,-47,-43,-35,12,399,29,528,-158,850583,13308,830190,7085,1.56%,97.60%,1.17,5.8,64,27,12,35,33,SEDANG
1/9/2021,DKI Jakarta,-21,8,-45,-41,-34,12,673,12,1088,-427,851256,13320,831278,6658,1.56%,97.65%,1.69,0.41,63,29,15,24,38,SEDANG
2/9/2021,DKI Jakarta,-20,7,-43,-42,-34,12,430,10,838,-418,851686,13330,832116,6240,1.57%,97.70%,0.64,0.83,60,29,11,30,28,SEDANG
3/9/2021,DKI Jakarta,-18,8,-37,-41,-32,13,343,11,832,-500,852029,13341,832948,5740,1.57%,97.76%,0.8,1.1,60,27,11,37,30,SEDANG
4/9/2021,DKI Jakarta,-21,9,-39,-35,-19,6,360,10,488,-138,852389,13351,833436,5602,1.57%,97.78%,1.05,0.91,58,26,10,31,28,SEDANG
5/9/2021,DKI Jakarta,-24,3,-46,-38,-14,6,303,10,317,-24,852692,13361,833753,5578,1.57%,97.78%,0.84,1,63,27,11,28,28,SEDANG
6/9/2021,DKI Jakarta,-21,4,-42,-41,-34,12,217,16,736,-535,852909,13377,834489,5043,1.57%,97.84%,0.72,1.6,68,31,11,26,24,SEDANG
7/9/2021,DKI Jakarta,-24,-1,-46,-40,-35,13,262,13,531,-282,853171,13390,835020,4761,1.57%,97.87%,1.21,0.81,52,28,9,19,24,SEDANG
8/9/2021,DKI Jakarta,-24,-3,-46,-40,-34,12,428,14,663,-249,853599,13404,835683,4512,1.57%,97.90%,1.63,1.08,53,25,16,23,34,SEDANG
9/9/2021,DKI Jakarta,-20,4,-41,-39,-33,11,308,13,484,-189,853907,13417,836167,4323,1.57%,97.92%,0.72,0.93,45,25,12,27,31,SEDANG
10/9/2021,DKI Jakarta,-17,6,-36,-39,-31,12,261,12,456,-207,854168,13429,836623,4116,1.57%,97.95%,0.85,0.92,51,27,10,25,32,SEDANG
11/9/2021,DKI Jakarta,-21,6,-40,-33,-18,6,268,20,400,-152,854436,13449,837023,3964,1.57%,97.96%,1.03,1.67,66,32,12,34,41,SEDANG
12/9/2021,DKI Jakarta,-25,0,-46,-36,-13,6,306,6,317,-17,854742,13455,837340,3947,1.57%,97.96%,1.14,0.3,61,26,10,28,27,SEDANG
13/09/2021,DKI Jakarta,-21,1,-45,-39,-34,12,187,6,453,-272,854929,13461,837793,3675,1.57%,98.00%,0.61,1,51,29,8,23,21,SEDANG
14/09/2021,DKI Jakarta,-28,-8,-55,-44,-38,15,190,3,499,-312,855119,13464,838292,3363,1.57%,98.03%,1.02,0.5,31,24,8,20,19,BAIK
15/09/2021,DKI Jakarta,-20,3,-43,-38,-34,11,305,10,506,-211,855424,13474,838798,3152,1.58%,98.06%,1.61,3.33,54,29,20,20,45,SEDANG
16/09/2021,DKI Jakarta,-20,3,-41,-39,-34,11,176,9,200,-33,855600,13483,838998,3119,1.58%,98.06%,0.58,0.9,48,29,9,23,24,SEDANG
17/09/2021,DKI Jakarta,-16,5,-35,-38,-32,12,206,5,368,-167,855806,13488,839366,2952,1.58%,98.08%,1.17,0.56,42,29,7,26,20,SEDANG
18/09/2021,DKI Jakarta,-20,6,-37,-32,-18,6,200,6,243,-49,856006,13494,839609,2903,1.58%,98.08%,0.97,1.2,50,29,8,23,22,SEDANG
19/09/2021,DKI Jakarta,-28,-5,-50,-36,-15,7,155,4,81,70,856161,13498,839690,2973,1.58%,98.08%,0.78,0.67,53,26,8,33,19,SEDANG
20/09/2021,DKI Jakarta,-20,4,-42,-38,-33,11,91,3,511,-423,856252,13501,840201,2550,1.58%,98.13%,0.59,0.75,51,27,10,25,34,SEDANG
21/09/2021,DKI Jakarta,-22,-1,-44,-38,-34,12,106,4,313,-211,856358,13505,840514,2339,1.58%,98.15%,1.16,1.33,55,28,11,29,36,SEDANG
22/09/2021,DKI Jakarta,-20,-1,-42,-39,-31,11,227,4,286,-63,856585,13509,840800,2276,1.58%,98.16%,2.14,1,57,29,11,24,32,SEDANG
23/09/2021,DKI Jakarta,-19,1,-39,-38,-31,11,165,2,265,-102,856750,13511,841065,2174,1.58%,98.17%,0.73,0.5,54,29,8,27,22,SEDANG
24/09/2021,DKI Jakarta,-15,6,-33,-37,-29,11,181,5,330,-154,856931,13516,841395,2020,1.58%,98.19%,1.1,2.5,57,34,8,20,26,SEDANG
25/09/2021,DKI Jakarta,-16,9,-36,-29,-16,5,133,3,198,-68,857064,13519,841593,1952,1.58%,98.19%,0.73,0.6,49,31,7,24,20,SEDANG
26/09/2021,DKI Jakarta,-20,1,-43,-32,-12,6,168,3,126,39,857232,13522,841719,1991,1.58%,98.19%,1.26,1,52,28,6,28,19,SEDANG
27/09/2021,DKI Jakarta,-18,4,-41,-37,-31,11,103,4,251,-152,857335,13526,841970,1839,1.58%,98.21%,0.61,1.33,51,27,12,22,33,SEDANG
28/09/2021,DKI Jakarta,-18,5,-42,-37,-32,11,104,3,176,-75,857439,13529,842146,1764,1.58%,98.22%,1.01,0.75,45,25,9,24,28,SEDANG
29/09/2021,DKI Jakarta,-17,5,-40,-36,-31,10,177,6,194,-23,857616,13535,842340,1741,1.58%,98.22%,1.7,2,54,26,12,29,38,SEDANG
30/09/2021,DKI Jakarta,-15,10,-38,-34,-29,10,149,3,193,-47,857765,13538,842533,1694,1.58%,98.22%,0.84,0.5,63,27,13,38,37,SEDANG
1/10/2021,DKI Jakarta,-9,16,-29,-33,-28,10,151,5,138,8,857916,13543,842671,1702,1.58%,98.22%,1.01,1.67,57,30,11,32,38,SEDANG
2/10/2021,DKI Jakarta,-11,17,-32,-24,-17,4,155,5,163,-13,858071,13548,842834,1689,1.58%,98.22%,1.03,1,67,32,11,30,35,SEDANG
3/10/2021,DKI Jakarta,-13,11,-39,-25,-13,4,127,4,89,34,858198,13552,842923,1723,1.58%,98.22%,0.82,0.8,70,29,10,28,28,SEDANG
4/10/2021,DKI Jakarta,-17,5,-39,-34,-30,10,149,1,169,-21,858347,13553,843092,1702,1.58%,98.22%,1.17,0.25,58,30,11,34,29,SEDANG
5/10/2021,DKI Jakarta,-15,9,-39,-33,-31,10,72,3,150,-81,858419,13556,843242,1621,1.58%,98.23%,0.48,3,55,29,11,30,33,SEDANG
6/10/2021,DKI Jakarta,-15,6,-35,-32,-30,10,203,4,164,35,858622,13560,843406,1656,1.58%,98.23%,2.82,1.33,60,38,10,26,35,SEDANG
7/10/2021,DKI Jakarta,-13,7,-32,-32,-29,9,150,1,100,49,858772,13561,843506,1705,1.58%,98.22%,0.74,0.25,45,29,9,21,28,SEDANG
8/10/2021,DKI Jakarta,-10,9,-25,-31,-28,10,150,0,307,-157,858922,13561,843813,1548,1.58%,98.24%,1,0,54,33,11,24,35,SEDANG
9/10/2021,DKI Jakarta,-12,12,-30,-24,-16,4,100,2,2,96,859022,13563,843815,1644,1.58%,98.23%,0.67,,52,27,9,32,29,SEDANG
10/10/2021,DKI Jakarta,-14,8,-35,-24,-11,4,140,3,69,68,859162,13566,843884,1712,1.58%,98.22%,1.4,1.5,58,26,9,38,26,SEDANG
11/10/2021,DKI Jakarta,-16,4,-35,-33,-28,10,41,2,309,-270,859203,13568,844193,1442,1.58%,98.25%,0.29,0.67,59,29,10,35,30,SEDANG
12/10/2021,DKI Jakarta,-16,4,-35,-33,-30,10,143,1,337,-195,859346,13569,844530,1247,1.58%,98.28%,3.49,0.5,56,37,9,23,35,SEDANG
13/10/2021,DKI Jakarta,-15,4,-33,-32,-28,9,278,0,199,79,859624,13569,844729,1326,1.58%,98.27%,1.94,0,52,28,8,25,31,SEDANG
14/10/2021,DKI Jakarta,-15,5,-32,-33,-28,10,113,0,98,15,859737,13569,844827,1341,1.58%,98.27%,0.41,1,64,33,11,35,35,SEDANG
15/10/2021,DKI Jakarta,-12,8,-25,-31,-26,10,124,0,64,60,859861,13569,844891,1401,1.58%,98.26%,1.1,1,75,29,12,34,37,TIDAK SEHAT
16/10/2021,DKI Jakarta,-15,8,-32,-23,-16,5,154,1,217,-64,860015,13570,845108,1337,1.58%,98.27%,1.24,,66,28,15,32,44,SEDANG
17/10/2021,DKI Jakarta,-18,3,-38,-26,-12,5,131,0,130,1,860146,13570,845238,1338,1.58%,98.27%,0.85,0,65,34,11,36,30,SEDANG
18/10/2021,DKI Jakarta,-27,-10,-46,-36,-31,12,107,1,149,-43,860253,13571,845387,1295,1.58%,98.27%,0.82,,44,25,9,19,26,SEDANG
19/10/2021,DKI Jakarta,-16,5,-35,-30,-32,9,106,0,122,-16,860359,13571,845509,1279,1.58%,98.27%,0.99,0,41,29,14,15,30,SEDANG
20/10/2021,DKI Jakarta,-14,2,-19,-44,-65,17,103,0,131,-28,860462,13571,845640,1251,1.58%,98.28%,0.97,1,33,29,10,21,27,SEDANG
21/10/2021,DKI Jakarta,-18,3,-31,-31,-28,9,88,1,153,-66,860550,13572,845793,1185,1.58%,98.29%,0.85,,45,25,9,28,32,SEDANG
22/10/2021,DKI Jakarta,-13,6,-24,-31,-26,10,83,0,83,0,860633,13572,845876,1185,1.58%,98.29%,0.94,0,64,31,18,19,48,SEDANG
23/10/2021,DKI Jakarta,-15,7,-24,-25,-14,5,116,2,173,-59,860749,13574,846049,1126,1.58%,98.29%,1.4,,57,29,10,20,36,SEDANG
24/10/2021,DKI Jakarta,-16,3,-27,-25,-10,5,131,1,128,2,860880,13575,846177,1128,1.58%,98.29%,1.13,0.5,58,27,11,28,36,SEDANG
25/10/2021,DKI Jakarta,-16,6,-32,-30,-27,9,82,1,166,-85,860962,13576,846343,1043,1.58%,98.30%,0.63,1,62,27,14,33,37,SEDANG
26/10/2021,DKI Jakarta,-16,5,-32,-30,-28,10,38,1,100,-63,861000,13577,846443,980,1.58%,98.31%,0.46,1,55,29,14,23,43,SEDANG
27/10/2021,DKI Jakarta,-19,-3,-33,-31,-27,10,105,1,145,-41,861105,13578,846588,939,1.58%,98.31%,2.76,1,55,29,15,22,39,SEDANG
28/10/2021,DKI Jakarta,-14,8,-27,-31,-27,9,131,1,99,31,861236,13579,846687,970,1.58%,98.31%,1.25,1,51,28,16,22,39,SEDANG
29/10/2021,DKI Jakarta,-6,15,-15,-27,-24,8,96,0,117,-21,861332,13579,846804,949,1.58%,98.31%,0.73,0,50,31,19,18,35,SEDANG
30/10/2021,DKI Jakarta,-11,12,-22,-21,-14,4,96,1,143,-48,861428,13580,846947,901,1.58%,98.32%,1,,48,31,12,25,40,SEDANG
31/10/2021,DKI Jakarta,-10,13,-22,-19,-9,3,113,1,77,35,861541,13581,847024,936,1.58%,98.31%,1.18,1,53,27,11,32,32,SEDANG
1/11/2021,DKI Jakarta,-16,5,-33,-30,-27,9,83,0,45,38,861624,13581,847069,974,1.58%,98.31%,0.73,0,58,32,16,22,41,SEDANG
2/11/2021,DKI Jakarta,-12,12,-29,-28,-28,9,77,0,124,-47,861701,13581,847193,927,1.58%,98.32%,0.93,1,50,29,14,22,35,SEDANG
3/11/2021,DKI Jakarta,-12,9,-26,-27,-26,8,132,1,100,31,861833,13582,847293,958,1.58%,98.31%,1.71,,49,33,13,21,38,SEDANG
4/11/2021,DKI Jakarta,-12,8,-25,-28,-26,9,111,1,51,59,861944,13583,847344,1017,1.58%,98.31%,0.84,1,57,30,17,34,47,SEDANG
5/11/2021,DKI Jakarta,-6,12,-15,-27,-24,9,119,1,35,83,862063,13584,847379,1100,1.58%,98.30%,1.07,1,56,31,19,18,46,SEDANG
6/11/2021,DKI Jakarta,-7,14,-16,-18,-16,3,68,1,256,-189,862131,13585,847635,911,1.58%,98.32%,0.57,1,55,30,13,22,40,SEDANG
7/11/2021,DKI Jakarta,-19,-3,-35,-24,-15,6,117,0,112,5,862248,13585,847747,916,1.58%,98.32%,1.72,0,38,27,8,23,25,SEDANG
8/11/2021,DKI Jakarta,-10,11,-22,-27,-26,8,29,0,79,-50,862277,13585,847826,866,1.58%,98.32%,0.25,1,38,29,18,15,32,SEDANG
9/11/2021,DKI Jakarta,-13,6,-26,-27,-27,9,93,0,147,-54,862370,13585,847973,812,1.58%,98.33%,3.21,1,55,32,14,17,38,SEDANG
10/11/2021,DKI Jakarta,-12,3,-25,-27,-25,8,95,0,59,36,862465,13585,848032,848,1.58%,98.33%,1.02,1,38,28,10,16,25,SEDANG
11/11/2021,DKI Jakarta,-9,9,-20,-27,-25,8,107,1,100,6,862572,13586,848132,854,1.58%,98.33%,1.13,,41,48,12,13,15,SEDANG
12/11/2021,DKI Jakarta,-13,-1,-22,-28,-23,9,71,0,186,-115,862643,13586,848318,739,1.57%,98.34%,0.66,0,32,31,10,16,9,BAIK
13/11/2021,DKI Jakarta,-15,3,-30,-23,-15,5,54,0,97,-43,862697,13586,848415,696,1.57%,98.34%,0.76,1,51,36,16,27,12,SEDANG
14/11/2021,DKI Jakarta,-8,10,-20,-19,-10,4,92,1,109,-18,862789,13587,848524,678,1.57%,98.35%,1.7,,42,29,11,18,7,SEDANG
15/11/2021,DKI Jakarta,-12,6,-24,-28,-25,8,36,1,78,-43,862825,13588,848602,635,1.57%,98.35%,0.39,1,27,30,8,16,7,BAIK
16/11/2021,DKI Jakarta,-12,5,-23,-27,-26,9,79,0,106,-27,862904,13588,848708,608,1.57%,98.35%,2.19,0,31,31,8,11,6,BAIK
17/11/2021,DKI Jakarta,-11,5,-21,-27,-25,8,130,1,172,-43,863034,13589,848880,565,1.57%,98.36%,1.65,,55,50,13,15,9,SEDANG
18/11/2021,DKI Jakarta,-10,6,-18,-28,-24,8,100,1,136,-37,863134,13590,849016,528,1.57%,98.36%,0.77,1,55,43,18,19,13,SEDANG
19/11/2021,DKI Jakarta,-7,8,-13,-26,-22,9,97,2,104,-9,863231,13592,849120,519,1.57%,98.37%,0.97,2,28,31,7,16,5,BAIK
20/11/2021,DKI Jakarta,-13,5,-24,-22,-14,5,114,1,158,-45,863345,13593,849278,474,1.57%,98.37%,1.18,0.5,28,33,7,13,6,BAIK
21/11/2021,DKI Jakarta,-10,6,-21,-20,-10,4,111,0,120,-9,863456,13593,849398,465,1.57%,98.37%,0.97,0,41,33,15,16,6,SEDANG
22/11/2021,DKI Jakarta,-12,6,-21,-26,-24,8,26,0,51,-25,863482,13593,849449,440,1.57%,98.37%,0.23,1,27,32,7,14,5,BAIK
23/11/2021,DKI Jakarta,-14,2,-25,-28,-26,9,69,0,43,26,863551,13593,849492,466,1.57%,98.37%,2.65,1,20,32,7,13,5,BAIK
24/11/2021,DKI Jakarta,-12,5,-21,-27,-24,8,82,1,105,-24,863633,13594,849597,442,1.57%,98.37%,1.19,,23,30,8,12,6,BAIK
25/11/2021,DKI Jakarta,-11,7,-18,-26,-24,8,54,1,42,11,863687,13595,849639,453,1.57%,98.37%,0.66,1,39,34,10,11,7,SEDANG
26/11/2021,DKI Jakarta,-10,5,-22,-26,-23,9,70,0,56,14,863757,13595,849695,467,1.57%,98.37%,1.3,0,34,32,12,9,7,SEDANG
27/11/2021,DKI Jakarta,-10,11,-23,-18,-14,4,54,0,86,-32,863811,13595,849781,435,1.57%,98.38%,0.77,1,30,30,10,8,5,BAIK
28/11/2021,DKI Jakarta,-10,8,-28,-19,-10,4,51,0,52,-1,863862,13595,849833,434,1.57%,98.38%,0.94,1,19,29,5,14,4,BAIK
29/11/2021,DKI Jakarta,-8,14,-17,-25,-24,8,41,0,71,-30,863903,13595,849904,404,1.57%,98.38%,0.8,1,23,30,7,12,5,BAIK
30/11/2021,DKI Jakarta,-9,14,-21,-25,-25,8,44,0,0,44,863947,13595,849904,448,1.57%,98.37%,1.07,1,29,31,9,18,7,BAIK
1/12/2021,DKI Jakarta,-6,18,-15,-23,-24,7,70,0,76,-6,864017,13595,849980,442,1.57%,98.38%,1.59,1,49,33,13,15,12,SEDANG
2/12/2021,DKI Jakarta,-6,17,-13,-24,-24,8,28,0,67,-39,864045,13595,850047,403,1.57%,98.38%,0.4,1,28,31,7,15,5,BAIK
3/12/2021,DKI Jakarta,-1,18,-6,-22,-22,8,42,0,68,-26,864087,13595,850115,377,1.57%,98.38%,1.5,1,49,32,9,19,7,BAIK
4/12/2021,DKI Jakarta,-8,13,-20,-16,-16,4,48,0,60,-12,864135,13595,850175,365,1.57%,98.38%,1.14,1,39,35,13,15,9,SEDANG
5/12/2021,DKI Jakarta,-10,8,-30,-16,-12,4,43,1,57,-15,864178,13596,850232,350,1.57%,98.39%,0.9,,41,39,15,15,9,SEDANG
6/12/2021,DKI Jakarta,-14,2,-26,-26,-24,9,14,2,53,-41,864192,13598,850285,309,1.57%,98.39%,0.33,2,60,55,23,18,11,SEDANG
7/12/2021,DKI Jakarta,-13,8,-28,-28,-26,10,31,1,38,-8,864223,13599,850323,301,1.57%,98.39%,2.21,0.5,30,34,12,16,9,BAIK
8/12/2021,DKI Jakarta,-6,11,-16,-23,-21,7,41,1,44,-4,864264,13600,850367,297,1.57%,98.39%,1.32,1,45,33,17,18,10,SEDANG
9/12/2021,DKI Jakarta,-7,9,-19,-25,-21,8,36,2,75,-41,864300,13602,850442,256,1.57%,98.40%,0.88,2,33,36,10,21,11,BAIK
10/12/2021,DKI Jakarta,-1,15,-8,-23,-18,8,26,0,36,-10,864326,13602,850478,246,1.57%,98.40%,0.72,0,46,43,14,19,12,SEDANG
11/12/2021,DKI Jakarta,-8,11,-21,-16,-9,3,32,0,42,-10,864358,13602,850520,236,1.57%,98.40%,1.23,1,28,33,8,24,9,BAIK
12/12/2021,DKI Jakarta,-4,12,-21,-14,-1,2,32,0,39,-7,864390,13602,850559,229,1.57%,98.40%,1,1,44,32,17,15,7,SEDANG
13/12/2021,DKI Jakarta,-7,11,-17,-25,-20,7,16,0,40,-24,864406,13602,850599,205,1.57%,98.40%,0.5,1,31,34,10,13,6,BAIK
14/12/2021,DKI Jakarta,-10,7,-20,-25,-22,8,20,0,25,-5,864426,13602,850624,200,1.57%,98.40%,1.25,1,46,46,15,16,10,SEDANG
15/12/2021,DKI Jakarta,-6,9,-19,-23,-20,7,23,0,25,-2,864449,13602,850649,198,1.57%,98.40%,1.15,1,58,43,19,20,14,SEDANG
16/12/2021,DKI Jakarta,-7,7,-20,-24,-20,7,40,0,38,2,864489,13602,850687,200,1.57%,98.40%,1.74,1,56,39,20,24,16,SEDANG
17/12/2021,DKI Jakarta,-2,13,-12,-23,-19,8,38,0,33,5,864527,13602,850720,205,1.57%,98.40%,0.95,1,53,42,18,24,15,SEDANG
18/12/2021,DKI Jakarta,-8,9,-24,-18,-8,3,74,0,30,44,864601,13602,850750,249,1.57%,98.40%,1.95,1,51,39,18,22,10,SEDANG
19/12/2021,DKI Jakarta,-3,11,-20,-14,-3,3,43,0,46,-3,864644,13602,850796,246,1.57%,98.40%,0.58,1,58,38,24,33,15,SEDANG
20/12/2021,DKI Jakarta,-9,5,-23,-25,-22,8,38,0,23,15,864682,13602,850819,261,1.57%,98.40%,0.88,1,52,39,13,23,11,SEDANG
21/12/2021,DKI Jakarta,-9,7,-24,-24,-23,8,55,2,20,33,864737,13604,850839,294,1.57%,98.39%,1.45,,52,41,19,22,17,SEDANG
22/12/2021,DKI Jakarta,-4,11,-16,-22,-22,7,43,1,20,22,864780,13605,850859,316,1.57%,98.39%,0.78,0.5,63,56,28,25,19,SEDANG
23/12/2021,DKI Jakarta,-8,5,-20,-23,-22,8,16,0,52,-36,864796,13605,850911,280,1.57%,98.39%,0.37,0,56,57,18,20,18,SEDANG
24/12/2021,DKI Jakarta,1,20,-6,-24,-25,8,69,0,29,40,864865,13605,850940,320,1.57%,98.39%,4.31,1,34,53,15,17,11,SEDANG
25/12/2021,DKI Jakarta,-10,8,-16,-24,-37,6,80,0,45,35,864945,13605,850985,355,1.57%,98.39%,1.16,1,53,56,17,17,9,SEDANG
26/12/2021,DKI Jakarta,-6,9,-21,-18,-4,3,47,0,24,23,864992,13605,851009,378,1.57%,98.38%,0.59,1,35,51,11,22,10,SEDANG
27/12/2021,DKI Jakarta,-5,12,-14,-26,-25,8,42,0,98,-56,865034,13605,851107,322,1.57%,98.39%,0.89,1,52,61,15,20,15,SEDANG
28/12/2021,DKI Jakarta,-7,10,-16,-25,-25,8,96,3,129,-36,865130,13608,851236,286,1.57%,98.39%,2.29,,51,53,15,18,13,SEDANG
29/12/2021,DKI Jakarta,-6,11,-15,-25,-25,8,27,0,0,27,865157,13608,851236,313,1.57%,98.39%,0.28,0,31,54,10,24,11,SEDANG
30/12/2021,DKI Jakarta,-2,18,-9,-22,-25,7,53,0,0,53,865210,13608,851236,366,1.57%,98.38%,1.96,1,55,53,16,23,14,SEDANG
31/12/2021,DKI Jakarta,2,34,4,-20,-33,6,87,1,0,86,865297,13609,851236,452,1.57%,98.38%,1.64,,62,52,23,20,14,SEDANG
